y̓uːqʷaː	0	4	0	4	0
y̓uːqʷaː	0	5	0	5	0
c̓us-ʼi·tap	0	4	0	4	0
y̓uːqʷaː	0	6	0	6	0
y̓uːqʷaː	0	7	0	7	0
wik	0	4	0	4	0
wik	0	5	0	5	0
suč̓as	4	0	0	4	0
qʷaː	2	2	0	4	0.6309297535714575
qʷaː	2	3	0	5	0.6126016192893443
ʔaḥʔaː	2	2	0	4	0.6309297535714575
qʷaː	2	4	0	6	0.579380164285695
ʔaḥʔaː	2	3	0	5	0.6126016192893443
wa·	0	4	0	4	0
wa·	0	5	0	5	0
ʔaḥʔaː	2	4	0	6	0.579380164285695
wa·	0	6	0	6	0
č̓apac	3	1	0	4	0.5118595071429148
ʔaḥʔaː	2	5	0	7	0.5445684476282008
wa·	0	7	0	7	0
wik	0	6	0	6	0
wik	0	7	0	7	0
ʔaḥ	3	0	1	4	0.5118595071429148
qʷaː	2	5	0	7	0.5445684476282008
ʔuḥ	0	4	0	4	0
ʔaḥ	4	0	1	5	0.4554859150035953
ʔu-ḥʷʼaɬ	0	4	0	4	0
qʷaː	2	6	0	8	0.5118595071429148
ʔu-ḥʷʼaɬ	0	5	0	5	0
wa·	0	8	0	8	0
qʷaː	2	7	0	9	0.48215936096968104
y̓uːqʷaː	0	8	0	8	0
wa·	0	9	0	9	0
hiɬ-yin	4	0	0	4	0
č̓apac	4	1	0	5	0.4554859150035953
ʔaḥʔaː	2	6	0	8	0.5118595071429148
hista-ʼi(ƛ)	0	4	0	4	0
č̓apac	5	1	0	6	0.41011848630651815
hawiɬ-čaq	0	4	0	4	0
wik	0	8	0	8	0
qʷaː	2	8	0	10	0.4554859150035953
ʔaḥʔaː	2	7	0	9	0.48215936096968104
piḥ	0	4	0	4	0
piḥ	0	5	0	5	0
wa·	0	10	0	10	0
wa·	0	11	0	11	0
wa·	0	12	0	12	0
hiɬ-yin	5	0	0	5	0
qʷaː	2	9	0	11	0.43158020163114585
y̓uːqʷaː	0	9	0	9	0
ƛiča·	4	0	0	4	0
wa·	0	13	0	13	0
ʔu-n̓a·ḥ	0	4	0	4	0
huːʔak	0	4	0	4	0
huːʔak	0	5	0	5	0
ʔaqi-ʔišt	4	0	0	4	0
wik	0	9	0	9	0
č̓apac	6	1	0	7	0.37330396038588737
ʔu-ḥʷʼaɬ	0	6	0	6	0
qʷaː	2	10	0	12	0.41011848630651815
qʷis	0	4	0	4	0
wik	0	10	0	10	0
wik	0	11	0	11	0
ʔu-n̓a·ḥ	0	5	0	5	0
qʷaː	3	10	0	13	0.4917150007886507
čačim	0	4	0	4	0
č̓apac-iːɬ	0	4	0	4	0
ʔaḥʔaː	2	8	0	10	0.4554859150035953
ʔaqi-ʔišt	5	0	0	5	0
čuː	0	4	0	4	0
č̓apac	7	1	0	8	0.34295098019812786
čačim	0	5	0	5	0
čuː	0	5	0	5	0
waː	0	4	0	4	0
č̓apac	8	1	0	9	0.3175206571427802
ʔu-(w)a(ƛ)	0	4	0	4	0
ʔaḥʔaː	2	9	0	11	0.43158020163114585
čuː	0	6	0	6	0
ʔaḥʔaː	2	10	0	12	0.41011848630651815
hawiɬ-čaq	0	5	0	5	0
hiɬ-yin	6	0	0	6	0
y̓uːqʷaː	0	10	0	10	0
ƛiča·	5	0	0	5	0
ʔaqi-ʔišt	6	0	0	6	0
ʔaḥʔaː	2	11	0	13	0.3907866554552209
qʷaː	4	10	0	14	0.5445684476282008
ʔaqi-ʔišt	7	0	0	7	0
ʔaḥ	5	0	1	6	0.41011848630651815
wa·	0	14	0	14	0
wa·	0	15	0	15	0
ʔuːš	1	1	2	4	0.9463946303571862
quːʔas	4	0	0	4	0
qʷaː	4	11	0	15	0.5278615371407821
quːʔas	5	0	0	5	0
wik-cuk	0	4	0	4	0
waː	0	5	0	5	0
waː	0	6	0	6	0
č̓apac-iːɬ	0	5	0	5	0
waː	0	7	0	7	0
qʷaː	4	12	0	16	0.5118595071429148
čuː	0	7	0	7	0
hawiɬ-čaq	0	6	0	6	0
qʷaː	4	13	0	17	0.4966215830615092
čačim	0	6	0	6	0
hawiɬ-čaq	0	7	0	7	0
č̓apac	9	1	0	10	0.2959032742893846
č̓apac	10	1	0	11	0.2772917256537885
ʔaḥ	6	0	1	7	0.37330396038588737
č̓apac	11	1	0	12	0.26108936338578836
ʔiːḥ-s	1	3	0	4	0.5118595071429148
č̓apac	12	1	0	13	0.2468472051870251
ʔuḥ	0	5	0	5	0
ʔaḥ	7	0	1	8	0.34295098019812786
qʷaː	4	14	0	18	0.48215936096968104
č̓apac-iːɬ	0	6	0	6	0
hawiɬ-čaq	0	8	0	8	0
tapʕaq	0	4	0	4	0
ʔu-taq	0	4	0	4	0
wa·	0	16	0	16	0
hiɬ-yin	7	0	0	7	0
ʔu-na·k	0	4	0	4	0
ʔaqi-ʔišt	8	0	0	8	0
č̓aḥʷ	0	4	0	4	0
č̓aḥʷ	0	5	0	5	0
hiš-caqs	3	1	0	4	0.5118595071429148
čačim	0	7	0	7	0
wa·	0	17	0	17	0
čuː	0	8	0	8	0
čačim	0	8	0	8	0
ḥuːɬ	0	4	0	4	0
hiɬ-yin	8	0	0	8	0
qʷis	0	5	0	5	0
hiš-caqs	4	1	0	5	0.4554859150035953
suːt	0	4	0	4	0
ḥumiːs	3	1	0	4	0.5118595071429148
ʔu-na·k	0	5	0	5	0
wa·	0	18	0	18	0
ʔaḥʔaː	2	12	0	14	0.37330396038588737
ʔaqi-ʔišt	9	0	0	9	0
ʔu-ḥʷʼaɬ	0	7	0	7	0
č̓apac-iːɬ	0	7	0	7	0
huːʔak	0	6	0	6	0
ʔaḥʔaː	2	13	0	15	0.35742770336531254
ʔaḥʔaː	2	14	0	16	0.34295098019812786
ḥuː	2	2	0	4	0.6309297535714575
qʷaːƛaː	0	4	0	4	0
qʷaː	4	15	0	19	0.46845749928108243
ʔaḥʔaː	3	14	0	17	0.42417080326490036
ƛiča·	6	0	0	6	0
ƛiča·	7	0	0	7	0
ʔu-ḥʷʼaɬ	0	8	0	8	0
č̓aḥʷ	0	6	0	6	0
č̓aḥʷ	0	7	0	7	0
wik	0	12	0	12	0
wik	0	13	0	13	0
waː	0	8	0	8	0
wik	0	14	0	14	0
wik	0	15	0	15	0
hawiɬ-čaq	0	9	0	9	0
qʷaː	5	15	0	20	0.5118595071429148
kʷama	4	0	0	4	0
čačim	0	9	0	9	0
qʷaː	5	16	0	21	0.49960699524890273
wik	0	16	0	16	0
ʔu-n̓a·ḥ	0	6	0	6	0
suč̓as	5	0	0	5	0
č̓apac	13	1	0	14	0.2342215203652865
huːʔak	0	7	0	7	0
č̓apac	14	1	0	15	0.22294491816723944
ʔaḥʔaː	4	14	0	18	0.48215936096968104
qʷaː	5	17	0	22	0.4878517150631748
č̓apac-iːɬ	0	8	0	8	0
wik	0	17	0	17	0
hawiɬ-čaq	0	10	0	10	0
huːʔak	0	8	0	8	0
qiː	0	4	0	4	0
ʔu-na·k	0	6	0	6	0
wa·	0	19	0	19	0
hiɬ-yin	8	1	0	9	0.3175206571427802
ʔu-na·k	0	7	0	7	0
qʷaːƛaː	0	5	0	5	0
ƛiča·	8	0	0	8	0
qʷaː	5	18	0	23	0.47658882290132026
y̓uːqʷaː	0	11	0	11	0
hawiɬ-čaq	0	11	0	11	0
č̓aḥʷ	0	8	0	8	0
wa·	0	20	0	20	0
ʔaḥʔaː	5	14	0	19	0.5246019307279569
qʷaː	5	19	0	24	0.46580588866142375
č̓apac-iːɬ	0	9	0	9	0
čuː	0	9	0	9	0
ʔu-kʷiɬ	0	4	0	4	0
hawiɬ-čaq	0	12	0	12	0
quːʔas	6	0	0	6	0
čamaqƛ	0	4	0	4	0
ḥuː	2	3	0	5	0.6126016192893443
hiɬ-yin	9	1	0	10	0.2959032742893846
ƛiča·	9	0	0	9	0
wik	0	18	0	18	0
hiɬ-yin	10	1	0	11	0.2772917256537885
č̓apac	15	1	0	16	0.21280633861277304
ḥumiːs	4	1	0	5	0.4554859150035953
wik	0	19	0	19	0
qiː	0	5	0	5	0
piḥ	0	6	0	6	0
ƛiča·	10	0	0	10	0
ʔu-ca	0	4	0	4	0
ʔaḥ	8	0	1	9	0.3175206571427802
č̓apac-iːɬ	0	10	0	10	0
ƛaḥ	0	4	0	4	0
ʔu-ḥʷʼaɬ	0	9	0	9	0
quːʔas	7	0	0	7	0
qʷaː	6	19	0	25	0.5016145675514594
wa·	0	21	0	21	0
mamaɬn̓i	4	0	0	4	0
č̓apac	16	1	0	17	0.20363696854060853
ʔaḥ	9	0	1	10	0.2959032742893846
quːʔas	8	0	0	8	0
huːʔak	0	9	0	9	0
ʔu-ḥʷʼaɬ-ckʷi·	0	4	0	4	0
qʷaː	7	19	0	26	0.5302072895899776
ʔuːš	2	1	2	5	0.9602297178607614
ʔaqi-ʔišt	10	0	0	10	0
ʔuːš	3	1	2	6	0.9206198357143052
quːʔas	9	0	0	9	0
wik	0	20	0	20	0
čuː	0	10	0	10	0
wa·	0	22	0	22	0
wa·	0	23	0	23	0
wa·	0	24	0	24	0
wa·	0	25	0	25	0
ʔumʔi·qsu	4	0	0	4	0
wa·	0	26	0	26	0
ʔu-ca	0	5	0	5	0
wa·	0	27	0	27	0
wa·	0	28	0	28	0
ʔana-siɬa	0	4	0	4	0
xaːšxiːp	3	1	0	4	0.5118595071429148
suč̓as	6	0	0	6	0
ʔana-siɬa	0	5	0	5	0
suč̓as	7	0	0	7	0
wik	0	21	0	21	0
wawaː	1	3	0	4	0.5118595071429148
maʔiƛqac	4	0	0	4	0
xaːšxiːp	3	2	0	5	0.6126016192893443
ʔumʔi·qsu	5	0	0	5	0
wawaː	1	4	0	5	0.4554859150035953
xaːšxiːp	3	3	0	6	0.6309297535714575
ʔumʔi·qsu	6	0	0	6	0
wik	0	22	0	22	0
qʷiyu	3	1	0	4	0.5118595071429148
wa·	0	29	0	29	0
ʔuːš	3	2	2	7	0.9821410328348753
qʷis	0	6	0	6	0
wa·	0	30	0	30	0
wik	0	23	0	23	0
qʷis	0	7	0	7	0
wa·	1	30	0	31	0.1297144305253523
č̓apac	17	1	0	18	0.1953001594734786
hiɬ	2	2	0	4	0.6309297535714575
wik	0	24	0	24	0
ʔuḥ	0	6	0	6	0
wa·	1	31	0	32	0.12657859363955407
ʔuyi	0	4	0	4	0
wa·	1	32	0	33	0.12360498799464747
muwač-m̓i·t	4	0	0	4	0
wa·	1	33	0	34	0.1207809362853011
wa·	1	34	0	35	0.11809506962344107
wa·	1	35	0	36	0.11553716142688074
qʷis	0	8	0	8	0
qʷis	0	9	0	9	0
wa·	1	36	0	37	0.11309798613327456
wa·	1	37	0	38	0.11076919850004079
wa·	1	38	0	39	0.10854323006054539
č̓apac	18	1	0	19	0.1876840927049947
wa·	2	38	0	40	0.1806963615767855
wa·	2	39	0	41	0.17741353268869126
č̓apac	19	1	0	20	0.1806963615767855
č̓apac	20	1	0	21	0.17425991310347752
ḥaw̓iɬ	3	1	0	4	0.5118595071429148
ḥaw̓iɬ	4	1	0	5	0.4554859150035953
wa·	2	40	0	42	0.17425991310347752
ḥaw̓iɬ	5	1	0	6	0.41011848630651815
muwač-m̓i·t	5	0	0	5	0
wawaː	1	5	0	6	0.41011848630651815
wa·	2	41	0	43	0.17122776556835204
wa·	2	42	0	44	0.1683099680160561
muwač-m̓i·t	6	0	0	6	0
ḥaw̓iɬ	6	1	0	7	0.37330396038588737
ḥaw̓iɬ	7	1	0	8	0.34295098019812786
č̓apac	21	1	0	22	0.1683099680160561
t̓uḥc̓iti	4	0	0	4	0
t̓uḥc̓iti	4	1	0	5	0.4554859150035953
ḥaw̓iɬ	7	2	0	9	0.48215936096968104
ḥaw̓iɬ	8	2	0	10	0.4554859150035953
ƛumk	0	4	0	4	0
wik	0	25	0	25	0
t̓uḥc̓iti	5	1	0	6	0.41011848630651815
t̓uḥc̓iti	6	1	0	7	0.37330396038588737
ƛumk	0	5	0	5	0
ƛumk	0	6	0	6	0
qʷis	0	10	0	10	0
ʔuḥ	0	7	0	7	0
muwač-m̓i·t	7	0	0	7	0
č̓apac	22	1	0	23	0.16279165503752757
wa·	2	43	0	45	0.16549995315030186
qʷis	1	10	0	11	0.2772917256537885
hin-in	0	4	0	4	0
qʷis	2	10	0	12	0.41011848630651815
muwač-m̓i·t	8	0	0	8	0
ḥaw̓iɬ	9	2	0	11	0.43158020163114585
čuː	0	11	0	11	0
wa·	2	44	0	46	0.16279165503752757
ʕaːnis-m̓i·t	4	0	0	4	0
wawaː	1	6	0	7	0.37330396038588737
wa·	2	45	0	47	0.16017946177442505
ʔaḥ	10	0	1	11	0.2772917256537885
wik	0	26	0	26	0
wa·	2	46	0	48	0.15765817343911248
ʕaːnis-m̓i·t	5	0	0	5	0
qʷayac̓iːk-štaqumɬ	4	0	0	4	0
ʔaːʔaːʔiša	0	4	0	4	0
ʔučq-c̓u·	4	0	0	4	0
ʕaːnis-m̓i·t	6	0	0	6	0
ʔuːš	4	2	2	8	0.9463946303571862
ʕaːnis-m̓i·t	7	0	0	7	0
naʔa·	0	4	0	4	0
ʕaːnis-m̓i·t	8	0	0	8	0
wa·	2	47	0	49	0.15522296464956845
wik	0	27	0	27	0
wawaː	1	7	0	8	0.34295098019812786
kuḥʷ-iqs	0	4	0	4	0
ʔučq	0	4	0	4	0
muwač-m̓i·t	9	0	0	9	0
t̓uḥc̓iti	6	2	0	8	0.5118595071429148
ḥaw̓iɬ	9	3	0	12	0.5118595071429148
muwač-m̓i·t	10	0	0	10	0
nunuːk	0	4	0	4	0
sukʷiƛ	0	4	0	4	0
ʔaḥ	11	0	1	12	0.26108936338578836
wa·	2	48	0	50	0.15286935115005695
ʔana-siɬa	0	6	0	6	0
qʷayac̓iːk-štaqumɬ	5	0	0	5	0
wa·	2	49	0	51	0.15059315992801106
muwač-m̓i·t	11	0	0	11	0
qʷis	2	11	0	13	0.3907866554552209
muwač-m̓i·t	12	0	0	12	0
wik	0	28	0	28	0
quːʔas	10	0	0	10	0
ʔuːš	4	3	2	9	0.9656336071428252
qʷaː	7	20	0	27	0.5209123406908595
ʔu-na·k	0	8	0	8	0
hiɬ	3	2	0	5	0.6126016192893443
ʔaḥ	12	0	1	13	0.2468472051870251
ʔu-na·k	0	9	0	9	0
qʷaː	7	21	0	28	0.5118595071429148
ʔu-na·k	0	10	0	10	0
wik	0	29	0	29	0
wa·	2	50	0	52	0.14839050243285176
ʕiniːƛ	4	0	0	4	0
ʔaḥʔaː	6	14	0	20	0.5560326498763891
y̓uːqʷaː	0	12	0	12	0
qʷaː	8	21	0	29	0.5361332756242887
numaːk	0	4	0	4	0
quːʔas	11	0	0	11	0
ʔu-n̓a·ḥ	0	7	0	7	0
ʕiniːƛ	5	0	0	5	0
ʕiniːƛ	6	0	0	6	0
ʔuːš	4	4	2	10	0.9602297178607614
ʕiniːƛ	7	0	0	7	0
quːʔas	12	0	0	12	0
ʔu-na·k	0	11	0	11	0
ʕiniːƛ	8	0	0	8	0
ʕiniːƛ	9	0	0	9	0
wa·	2	51	0	53	0.14625775052666262
qʷaː	8	22	0	30	0.5278615371407821
wa·	2	52	0	54	0.1441915148462777
huːʔak	0	10	0	10	0
qʷaː	8	23	0	31	0.5197672707950403
ʕiniːƛ	10	0	0	10	0
ʔu-na·k	0	12	0	12	0
quːʔas	13	0	0	13	0
numaːk	0	5	0	5	0
qʷaː	8	24	0	32	0.5118595071429148
quːʔas	14	0	0	14	0
hiɬ	3	3	0	6	0.6309297535714575
quːʔas	15	0	0	15	0
quːʔas	16	0	0	16	0
wa·	2	53	0	55	0.14218862529861417
sut-(č)iɬ	0	4	0	4	0
qʷiyu	4	1	0	5	0.4554859150035953
quːʔas	17	0	0	17	0
wik	0	30	0	30	0
quːʔas	18	0	0	18	0
qʷaː	8	25	0	33	0.5041434864740977
qʷaː	9	25	0	34	0.526047087442954
ʕiniːƛ	11	0	0	11	0
qʷaː	9	26	0	35	0.5188792956179065
qʷaː	9	27	0	36	0.5118595071429148
y̓uːqʷaː	0	13	0	13	0
ƛaʔuː	3	1	0	4	0.5118595071429148
ʕiniːƛ	12	0	0	12	0
qʷaː	9	28	0	37	0.5049912585825583
ḥaw̓iɬ	10	3	0	13	0.4917150007886507
ʕiniːƛ	13	0	0	13	0
ḥaw̓iɬ	11	3	0	14	0.472941950941057
wa·	2	54	0	56	0.14024611344719426
wa·	2	55	0	57	0.1383611965787174
quːʔas	19	0	0	19	0
huḥtak	0	4	0	4	0
qʷaː	9	29	0	38	0.4982763019965377
qʷaː	10	29	0	39	0.5181705821880989
ʕiniːƛ	14	0	0	14	0
ʕiniːƛ	14	1	0	15	0.22294491816723944
ʕiniːƛ	15	1	0	16	0.21280633861277304
ḥaw̓iɬ	12	3	0	15	0.4554859150035953
ʕiniːƛ	16	1	0	17	0.20363696854060853
ʕiniːƛ	17	1	0	18	0.1953001594734786
qiː	0	6	0	6	0
ʕiniːƛ	18	1	0	19	0.1876840927049947
ʔaḥʔaː	6	15	0	21	0.5445684476282008
hiɬ	3	4	0	7	0.6216097450797567
ḥaː	1	3	0	4	0.5118595071429148
qʷaː	10	30	0	40	0.5118595071429148
ʔaḥʔaː	7	15	0	22	0.5693467715383745
quːʔas	20	0	0	20	0
wa·	2	56	0	58	0.13653126326509574
quːʔas	20	1	0	21	0.17425991310347752
wik	0	31	0	31	0
wik	0	32	0	32	0
quːʔas	21	1	0	22	0.1683099680160561
nay̓iːk	0	4	0	4	0
wa·	2	57	0	59	0.1347538602592167
čuː	0	12	0	12	0
haʔuk	0	4	0	4	0
ʔaḥ	13	0	1	14	0.2342215203652865
wa·	2	58	0	60	0.1330266805824107
wik	0	33	0	33	0
ʕiniːƛ	19	1	0	20	0.1806963615767855
wik	0	34	0	34	0
y̓uːqʷaː	0	14	0	14	0
ʕiniːƛ	20	1	0	21	0.17425991310347752
qʷis	3	11	0	14	0.472941950941057
ʔuːš	4	4	3	11	0.9922150607220183
ʕiniːƛ	21	1	0	22	0.1683099680160561
čuː	0	13	0	13	0
qʷis	3	12	0	15	0.4554859150035953
quːʔas	22	1	0	23	0.16279165503752757
wik	0	35	0	35	0
ʔu-kʷiɬ	0	5	0	5	0
qʷiyu	5	1	0	6	0.41011848630651815
y̓uːqʷaː	0	15	0	15	0
wik	0	36	0	36	0
y̓uːqʷaː	0	16	0	16	0
wik	0	37	0	37	0
naʔa·	0	5	0	5	0
qʷaː	10	31	0	41	0.5056712021696796
wik	0	38	0	38	0
qʷaː	11	31	0	42	0.5234238051125707
ḥuː	2	4	0	6	0.579380164285695
ʔaḥʔaː	8	15	0	23	0.5880969216574936
ciq	1	3	0	4	0.5118595071429148
čuː	0	14	0	14	0
ʔaḥʔaː	9	15	0	24	0.6021808102656679
quːʔas	23	1	0	24	0.15765817343911248
wik	0	39	0	39	0
naʔa·	0	6	0	6	0
wik	0	40	0	40	0
wawaː	1	8	0	9	0.3175206571427802
wawaː	1	9	0	10	0.2959032742893846
y̓uːqʷaː	0	17	0	17	0
qʷaː	12	31	0	43	0.538927706342274
wawaː	1	10	0	11	0.2772917256537885
naq	0	4	0	4	0
qʷis	3	13	0	16	0.4392610297141858
ʔaḥʔaː	10	15	0	25	0.6126016192893443
quːʔas	24	1	0	25	0.15286935115005695
wik	0	41	0	41	0
qʷaː	13	31	0	44	0.5524820883299218
qʷaː	14	31	0	45	0.5643363070906433
ḥaːḥuːp	0	4	0	4	0
čuː	0	15	0	15	0
ʔu-ksnaʕaːɬ	0	4	0	4	0
ʕiniːƛ	22	1	0	23	0.16279165503752757
wawaː	1	11	0	12	0.26108936338578836
nani·qsu	3	1	0	4	0.5118595071429148
wik	0	42	0	42	0
ḥaːkʷa·ƛ	3	1	0	4	0.5118595071429148
ʕiniːƛ	22	2	0	24	0.26108936338578836
ʕiniːƛ	23	2	0	25	0.25374681736588833
ʕiniːƛ	24	2	0	26	0.2468472051870251
ʔumʔi·qsu	7	0	0	7	0
wik	0	43	0	43	0
naʔa·	0	7	0	7	0
nunuːk	1	4	0	5	0.4554859150035953
wa·	2	59	0	61	0.13134755267865894
ƛawa-uɬ	0	4	0	4	0
nunuːk	2	4	0	6	0.579380164285695
nunuːk	2	5	0	7	0.5445684476282008
wawaː	1	12	0	13	0.2468472051870251
ʔumʔi·qsu	8	0	0	8	0
ʔumʔi·qsu	9	0	0	9	0
ḥaːw̓iːḥaƛ	4	0	0	4	0
ʔaḥ	14	0	1	15	0.22294491816723944
qʷis	3	14	0	17	0.42417080326490036
ʔuyi	0	5	0	5	0
ƛ̓aːq	4	0	0	4	0
ḥuː	2	5	0	7	0.5445684476282008
wa·	2	60	0	62	0.1297144305253523
ʔu-(w)a(ƛ)	0	5	0	5	0
ʔaḥ	15	0	1	16	0.21280633861277304
ƛ̓aːq	5	0	0	5	0
ʔaḥʔaː	10	16	0	26	0.6064727741416686
huʔa-ca	0	4	0	4	0
mat	0	4	0	4	0
mat	0	5	0	5	0
qʷis	3	15	0	18	0.41011848630651815
wa·	3	60	0	63	0.17425991310347752
ɬuːcma	4	0	0	4	0
ƛ̓aːq	6	0	0	6	0
huʔa-ca	0	5	0	5	0
mat	0	6	0	6	0
ɬuːcma	5	0	0	5	0
ʔu-ca-ḥta	0	4	0	4	0
waɬ	0	4	0	4	0
wik	0	44	0	44	0
maːʔak	4	0	0	4	0
wik	0	45	0	45	0
wik	0	46	0	46	0
ʔunw̓iːƛ	0	4	0	4	0
quːʔas	25	1	0	26	0.14839050243285176
huːʔak	0	11	0	11	0
ʔuyi	0	6	0	6	0
quːʔas	26	1	0	27	0.1441915148462777
wik	0	47	0	47	0
ʔuḥ	0	8	0	8	0
qʷaː	14	32	0	46	0.559345027039261
hiɬ	3	5	0	8	0.6021808102656679
qiː	0	7	0	7	0
waː	0	9	0	9	0
quːʔas	27	1	0	28	0.14024611344719426
ʔuːš	5	4	3	12	0.9808340377961404
čačim	1	9	0	10	0.2959032742893846
hiɬ	4	5	0	9	0.6252993742043006
quːʔas	28	1	0	29	0.13653126326509574
qʷaː	15	32	0	47	0.5700157289499047
hupaɬ	4	0	0	4	0
qʷaːƛaː	0	6	0	6	0
hupaɬ	5	0	0	5	0
ƛaʔuː	4	1	0	5	0.4554859150035953
waː	0	10	0	10	0
č̓apac	23	1	0	24	0.15765817343911248
čuː	0	16	0	16	0
wa·	3	61	0	64	0.17222543611591343
wa·	3	62	0	65	0.17024279601586934
t̓apat	0	4	0	4	0
čuː	0	17	0	17	0
huːʔak	0	12	0	12	0
č̓apac	24	1	0	25	0.15286935115005695
t̓apat	0	5	0	5	0
ʔaḥ	16	0	1	17	0.20363696854060853
ʔaya	0	4	0	4	0
huḥtak	0	5	0	5	0
qʷiyu	6	1	0	7	0.37330396038588737
ʔuːš-yuːya	0	4	0	4	0
ʔuːš-yuːya	0	5	0	5	0
qʷis	4	15	0	19	0.46845749928108243
quːʔas	29	1	0	30	0.1330266805824107
wik̓iːt	0	4	0	4	0
quːʔas	30	1	0	31	0.1297144305253523
huːʔak	0	13	0	13	0
ʔuyi	0	7	0	7	0
wik̓iːt	0	5	0	5	0
ʔu-na·k	0	13	0	13	0
qʷayac̓iːk-štaqumɬ	6	0	0	6	0
qʷayac̓iːk-štaqumɬ	7	0	0	7	0
quːʔas	31	1	0	32	0.12657859363955407
ʔinkʷ	4	0	0	4	0
wim̓aːqƛ	0	4	0	4	0
wa·	3	63	0	66	0.1683099680160561
ḥaː	2	3	0	5	0.6126016192893443
muwač-m̓i·t	13	0	0	13	0
naʔa·	0	8	0	8	0
ciq	1	4	0	5	0.4554859150035953
ḥaː	3	3	0	6	0.6309297535714575
quːʔas	32	1	0	33	0.12360498799464747
wim̓aːqƛ	0	5	0	5	0
qʷayac̓iːk-štaqumɬ	8	0	0	8	0
muwač-m̓i·t	14	0	0	14	0
muwač-m̓i·t	15	0	0	15	0
wa·	3	64	0	67	0.1664250331311436
wim̓aːqƛ	0	6	0	6	0
ʔinkʷ	5	0	0	5	0
wa·	3	65	0	68	0.1645861712996456
muwač-m̓i·t	16	0	0	16	0
ʔinkʷ	6	0	0	6	0
wa·	3	66	0	69	0.16279165503752757
wa·	3	67	0	70	0.16103984357614579
ḥaw̓iɬ	13	3	0	16	0.4392610297141858
wa·	3	68	0	71	0.15932917744188776
muwač-m̓i·t	17	0	0	17	0
wa·	3	69	0	72	0.15765817343911248
ḥaw̓iɬ	14	3	0	17	0.42417080326490036
ʔu-kʷiːɬ	0	4	0	4	0
wik	0	48	0	48	0
qiː	0	8	0	8	0
muwač-m̓i·t	18	0	0	18	0
čuː	0	18	0	18	0
yaqʷ	4	0	0	4	0
nunuːk	2	6	0	8	0.5118595071429148
wa·	3	70	0	73	0.15602542000175906
muwač-m̓i·t	19	0	0	19	0
wa·	3	71	0	74	0.15442957288234227
ʔiːqḥ	0	4	0	4	0
qʷiyu	7	1	0	8	0.34295098019812786
wa·	3	72	0	75	0.15286935115005695
ʔuḥ	0	9	0	9	0
ḥaː	4	3	0	7	0.6216097450797567
nunuːk	3	6	0	9	0.579380164285695
ƛawa	0	4	0	4	0
hiɬ-ʼatḥ	4	0	0	4	0
qʷayac̓iːk-štaqumɬ	9	0	0	9	0
wa·	3	73	0	76	0.1513435334723838
nunuːk	4	6	0	10	0.6126016192893443
nunuːk	4	7	0	11	0.5966452229439912
muwač-m̓i·t	20	0	0	20	0
n̓aːcsa	0	4	0	4	0
qʷayac̓iːk-štaqumɬ	10	0	0	10	0
wa·	3	74	0	77	0.14985095465698842
ḥaw̓iɬ	15	3	0	18	0.41011848630651815
qʷayac̓iːk-štaqumɬ	11	0	0	11	0
ʔuḥ	0	10	0	10	0
muwač-m̓i·t	21	0	0	21	0
wa·	3	75	0	78	0.14839050243285176
čaʔaːɬ-či·	0	4	0	4	0
wa·	3	76	0	79	0.14696111445149668
wa·	3	77	0	80	0.14556177549090507
ɬuːcma	6	0	0	6	0
ḥaw̓iɬ	16	3	0	19	0.3970120577425188
wa·	3	78	0	81	0.1441915148462777
mač	0	4	0	4	0
wa·	3	79	0	82	0.1428494038931897
ḥaw̓iɬ	17	3	0	20	0.3847663931726611
mač	0	5	0	5	0
nunuːk	4	8	0	12	0.579380164285695
muwač-m̓i·t	22	0	0	22	0
muwač-m̓i·t	23	0	0	23	0
muwač-m̓i·t	24	0	0	24	0
wawaː	1	13	0	14	0.2342215203652865
čuː	0	19	0	19	0
qʷiyu	8	1	0	9	0.3175206571427802
hiš-umɬ	0	4	0	4	0
ḥumiːs	5	1	0	6	0.41011848630651815
ʔu-ca	0	6	0	6	0
ʔaḥ	17	0	1	18	0.1953001594734786
huːɬ	0	4	0	4	0
ʔinkʷ	7	0	0	7	0
ḥaː	5	3	0	8	0.6021808102656679
ʔinkʷ	8	0	0	8	0
wim̓aːqƛ	0	7	0	7	0
ƛawa	0	5	0	5	0
ḥaː	6	3	0	9	0.579380164285695
wik	0	49	0	49	0
ƛawa	0	6	0	6	0
ʔinkʷ	9	0	0	9	0
wik	0	50	0	50	0
qʷis	5	15	0	20	0.5118595071429148
qʷayac̓iːk-štaqumɬ	12	0	0	12	0
muwač-m̓i·t	25	0	0	25	0
ʔinkʷ	10	0	0	10	0
kamatq	0	4	0	4	0
ʔinkʷ	10	1	0	11	0.2772917256537885
ḥaː	7	3	0	10	0.5560326498763891
ḥumiːs	6	1	0	7	0.37330396038588737
ʔinkʷ	11	1	0	12	0.26108936338578836
hiːnip	0	4	0	4	0
hin-in	0	5	0	5	0
hiɬ-ʼatḥ	5	0	0	5	0
ʔuʔumḥi	0	4	0	4	0
ʔuʔumḥi	0	5	0	5	0
ʔunw̓iːƛ	0	5	0	5	0
ʔinkʷ	12	1	0	13	0.2468472051870251
ʕaːnis-m̓i·t	9	0	0	9	0
ʔuʔumḥi	0	6	0	6	0
ʔu-ca	0	7	0	7	0
wim̓aːqƛ	0	8	0	8	0
ʕaːnis-m̓i·t	10	0	0	10	0
ḥaːkʷa·ƛ	4	1	0	5	0.4554859150035953
sut-(č)iɬ	0	5	0	5	0
wa·	3	80	0	83	0.14153455380996047
ʕaːnis-m̓i·t	11	0	0	11	0
wik	0	51	0	51	0
wa·	3	81	0	84	0.14024611344719426
ʕaːnis-m̓i·t	12	0	0	12	0
ʕaːnis-m̓i·t	13	0	0	13	0
wik-sa	0	4	0	4	0
wa·	3	82	0	85	0.13898326733348307
wa·	3	83	0	86	0.137745233807192
ʕaːnis-m̓i·t	14	0	0	14	0
ʔu-n̓a·ḥ	0	8	0	8	0
ʔu-kʷiɬ	0	6	0	6	0
wawaː	1	14	0	15	0.22294491816723944
n̓aːcsa	0	5	0	5	0
ʔi·ḥʷ	0	3	1	4	0.5118595071429148
t̓apat	0	6	0	6	0
wik-cuk	0	5	0	5	0
wa·	3	84	0	87	0.13653126326509574
ʔu-ca	0	8	0	8	0
ʔi·ḥʷ	0	4	1	5	0.4554859150035953
ʔaḥ	18	0	1	19	0.1876840927049947
wa·	3	85	0	88	0.13534063651939773
ʔaḥ	19	0	1	20	0.1806963615767855
n̓aːcsa	0	6	0	6	0
qʷis	5	16	0	21	0.49960699524890273
ʕaːnis-m̓i·t	15	0	0	15	0
wa·	4	85	0	89	0.1668918780366221
wa·	4	86	0	90	0.16549995315030186
n̓aːcsa	0	7	0	7	0
hihiq-tu·p	4	0	0	4	0
ʔana	0	3	1	4	0.5118595071429148
ʕaːnis-m̓i·t	16	0	0	16	0
nučiː	4	0	0	4	0
qiː	0	9	0	9	0
muːɬ	1	3	0	4	0.5118595071429148
hihiq-tu·p	5	0	0	5	0
hihiq-tu·p	6	0	0	6	0
y̓uːqʷaː	0	18	0	18	0
maːmaːti	3	1	0	4	0.5118595071429148
ƛuːɬ-ḥap	0	4	0	4	0
ʕaːnis-m̓i·t	17	0	0	17	0
n̓aːcsiː	0	4	0	4	0
ʕaːnis-m̓i·t	18	0	0	18	0
wik̓iːt	0	6	0	6	0
huḥtak	0	6	0	6	0
ʔuḥ	0	11	0	11	0
saːpinq-as	4	0	0	4	0
ʔunw̓iːƛ	0	6	0	6	0
qʷis	5	17	0	22	0.4878517150631748
ʕaːnis-m̓i·t	19	0	0	19	0
ʔunw̓iːƛ	0	7	0	7	0
ʔaḥʔaː	11	16	0	27	0.6152316313459706
saːpinq-as	5	0	0	5	0
kʷis-ca	0	4	0	4	0
n̓aːcsa	0	8	0	8	0
qʷaː	15	33	0	48	0.5653371812436326
ƛaḥ	0	5	0	5	0
ʔuyi	0	8	0	8	0
wiːy̓a	0	4	0	4	0
ḥaːḥuːp-(y)a·-y̓akʷ	3	1	0	4	0.5118595071429148
ʔunw̓iːƛ	0	8	0	8	0
ʔaḥʔaː	12	16	0	28	0.6216097450797567
wiːy̓a	0	5	0	5	0
quːʔas	33	1	0	34	0.1207809362853011
wiːy̓a	0	6	0	6	0
ʔu-ktis	0	4	0	4	0
qʷaː	16	33	0	49	0.5749930206936642
ƛuɬ	0	4	0	4	0
quːʔas	34	1	0	35	0.11809506962344107
ɬuːcma	7	0	0	7	0
ʔu-na·k	0	14	0	14	0
ʔuḥ	0	12	0	12	0
ʔaḥʔaː	12	17	0	29	0.6173327941976077
ʔumʔi·qsu	10	0	0	10	0
ƛaʔuː	4	2	0	6	0.579380164285695
yaq	4	0	0	4	0
ʔu-kʷiɬ	0	7	0	7	0
ʔuːš-yuːya	0	6	0	6	0
yaqʷ	5	0	0	5	0
ḥaw̓iɬ	17	4	0	21	0.44320704809783756
ʔu-na·k	0	15	0	15	0
ʔu-na·k	0	16	0	16	0
ʔaḥʔaː	12	18	0	30	0.6126016192893443
yaq	5	0	0	5	0
ƛaʔuː	4	2	1	7	0.8699155297736261
nani·qsu	4	1	0	5	0.4554859150035953
n̓aːcsa	0	9	0	9	0
yaq	6	0	0	6	0
nani·qsu	5	1	0	6	0.41011848630651815
ʔu-kɬa·	0	4	0	4	0
ƛaʔuː	4	3	1	8	0.886859507142915
yaq	7	0	0	7	0
qʷaː	16	34	0	50	0.5706011702567104
qʷaː	16	35	0	51	0.5662135177831442
nani·qsu	5	2	0	7	0.5445684476282008
yaq	8	0	0	8	0
qʷaː	16	36	0	52	0.5618376711211267
y̓uːqʷaː	0	19	0	19	0
nani·qsu	6	2	0	8	0.5118595071429148
nani·qsu	7	2	0	9	0.48215936096968104
his-taq	0	4	0	4	0
ʔu-kɬa·	0	5	0	5	0
ɬuːcma	8	0	0	8	0
wa·	4	87	0	91	0.16413345036828847
wa·	4	88	0	92	0.16279165503752757
ʔuyi	0	9	0	9	0
ʔaḥʔaː	13	18	0	31	0.6190381373398363
ʔaḥʔaː	13	19	0	32	0.6148343591439298
ʔu-ca	0	9	0	9	0
ʔaḥ	19	1	1	21	0.3463516860337494
hin-in	0	6	0	6	0
yaq	9	0	0	9	0
nani·qsu	7	3	0	10	0.5560326498763891
ʕiḥ	0	4	0	4	0
huʔa-ca	0	6	0	6	0
ʔaḥʔaː	13	20	0	33	0.6102950565119215
hiɬ	4	6	0	10	0.6126016192893443
ʔaya	0	4	1	5	0.4554859150035953
wik	0	52	0	52	0
qʷiyu	9	1	0	10	0.2959032742893846
ʔaʔim	1	3	0	4	0.5118595071429148
wawaː	2	14	0	16	0.34295098019812786
ciq	1	5	0	6	0.41011848630651815
ʔuːš-yuːya	0	7	0	7	0
ʔaḥʔaː	13	21	0	34	0.6054950153947242
ʔaya	0	4	2	6	0.579380164285695
ʔaḥ	20	1	1	22	0.3346489759784665
qʷaː	16	37	0	53	0.5574801206358024
haʔuk	0	5	0	5	0
hiɬ	5	6	0	11	0.62716323636974
hupaɬ	6	0	0	6	0
ʔac-yu·	0	4	0	4	0
yaqʷ-(č)iɬ	3	1	0	4	0.5118595071429148
ma-maɬ-n̓i·	4	0	0	4	0
wa·	4	89	0	93	0.16147387949094394
ʔac-yu·	0	5	0	5	0
ʔu-ʼiːḥ	0	4	0	4	0
yaqʷ-(č)iɬ	4	1	0	5	0.4554859150035953
wa·	4	90	0	94	0.16017946177442505
haʔuk	0	6	0	6	0
ʔu-ʼiːḥ	0	5	0	5	0
qʷaː	16	38	0	54	0.5531463921705145
ʔac-yu·	0	6	0	6	0
ʔuːš-yuːya	0	8	0	8	0
muwač	4	0	0	4	0
ʔu-ʼiːḥ	0	6	0	6	0
qʷaː	17	38	0	55	0.5628658597104059
ʔiʔišpaːɬ	4	0	0	4	0
ʔaḥʔaː	13	22	0	35	0.6004953903967951
qʷis	6	17	0	23	0.5224449947571249
hiɬ	5	7	0	12	0.6182283531662822
ʔu-kɬa·	0	6	0	6	0
hiɬ-ʼatḥ	5	1	0	6	0.41011848630651815
ʔaya	1	4	2	7	0.8699155297736261
ḥaː	7	4	0	11	0.5966452229439912
hiɬ-ʼatḥ	5	2	0	7	0.5445684476282008
ʔac-yu·	0	7	0	7	0
ʔu-ʼiːḥ	0	7	0	7	0
hupaɬ	7	0	0	7	0
wa·	4	91	0	95	0.15890776444551077
hupaɬ	8	0	0	8	0
ḥaːkʷa·ƛ	5	1	0	6	0.41011848630651815
ƛiḥ	0	4	0	4	0
wa·	4	92	0	96	0.15765817343911248
hupaɬ	9	0	0	9	0
ʔišc̓iːp-m̓i·t	3	1	0	4	0.5118595071429148
č̓apac	25	1	0	26	0.14839050243285176
ʔu-kɬa·	0	7	0	7	0
ʔiʔišpaːɬ	5	0	0	5	0
ʔiʔišpaːɬ	6	0	0	6	0
qʷaː	17	39	0	56	0.5587595107114636
čaːni	0	4	0	4	0
čuː	0	20	0	20	0
ʔu-ca	0	10	0	10	0
ʔaḥʔaː	13	23	0	36	0.5953463447053444
wik̓iːt	0	7	0	7	0
wik̓iːt	0	8	0	8	0
huḥtak	0	7	0	7	0
qiː	0	10	0	10	0
qʷaː	17	40	0	57	0.5546729127366281
ʔaḥʔaː	13	24	0	37	0.5900891279401312
wik̓iːt	0	9	0	9	0
huːʔak	0	14	0	14	0
ʔuyi	0	10	0	10	0
ʔaḥʔaː	13	25	0	38	0.5847577236324994
čaːni	0	5	0	5	0
hiɬ	5	8	0	13	0.6064727741416686
yaq	10	0	0	10	0
ʔaḥ	21	1	1	23	0.3237837983572335
ʔaḥʔaː	13	26	0	39	0.579380164285695
hiɬ	5	9	0	14	0.593254388190763
qiː	0	11	0	11	0
ʔaḥʔaː	13	27	0	40	0.5739795876036419
huʔa-ca	0	7	0	7	0
qiː	0	12	0	12	0
ʔu-na·k	0	17	0	17	0
hiɬ	5	10	0	15	0.579380164285695
mamuːk	0	4	0	4	0
ʔuyi	0	11	0	11	0
mamuːk	0	5	0	5	0
k̓ʷis	0	4	0	4	0
hawiɬ-čaq	0	13	0	13	0
čaːni	0	6	0	6	0
ʔac-yu·	0	8	0	8	0
wa·	4	93	0	97	0.15643009699593263
yaq	11	0	0	11	0
wa·	4	94	0	98	0.15522296464956845
waː	0	11	0	11	0
qiː	0	13	0	13	0
sut-(č)iɬ	0	6	0	6	0
ḥaːḥuːp	0	5	0	5	0
waː	0	12	0	12	0
qiː	0	14	0	14	0
sut-(č)iɬ	0	7	0	7	0
ḥaːḥuːp	0	6	0	6	0
ʔuyi	0	12	0	12	0
ʔaya	1	5	2	8	0.8194483718728036
ʔaḥʔaː	13	28	0	41	0.5685750896865958
ʔunic	0	4	0	4	0
ʔu-ʼiːḥ	0	8	0	8	0
waː	0	13	0	13	0
ʔu-ʼiːḥ	0	9	0	9	0
nas	0	4	0	4	0
ʔuːš-yuːya	0	9	0	9	0
mamuːk	0	6	0	6	0
ʔaḥʔaː	13	29	0	42	0.5631824178672722
waɬ	0	5	0	5	0
čaːni	0	7	0	7	0
waɬ	0	6	0	6	0
waɬ	0	7	0	7	0
qiː	0	15	0	15	0
waː	0	14	0	14	0
hiɬ	6	10	0	16	0.6021808102656679
ʔaḥʔaː	13	30	0	43	0.5578145360830786
yaq	12	0	0	12	0
waɬaːk	0	4	0	4	0
waː	0	15	0	15	0
hiɬ	6	11	0	17	0.5909713204264327
č̓apac	26	1	0	27	0.1441915148462777
hiɬ	6	12	0	18	0.579380164285695
ƛaḥ	1	5	0	6	0.41011848630651815
č̓apac	27	1	0	28	0.14024611344719426
ʔaḥʔaː	14	30	0	44	0.5693467715383745
his-taq	0	5	0	5	0
waː	0	16	0	16	0
ʔu-ca	0	11	0	11	0
č̓apac	28	1	0	29	0.13653126326509574
hiɬ	6	13	0	19	0.5676751079529517
qacc̓a	0	3	1	4	0.5118595071429148
t̓aːtn̓a	4	0	0	4	0
ɬuːcma	8	1	0	9	0.3175206571427802
huːʔak	0	15	0	15	0
mamuːk	0	7	0	7	0
ʔaḥʔaː	14	31	0	45	0.5643363070906433
ʔaḥ	22	1	1	24	0.3136668428500765
huḥtak	0	8	0	8	0
naʔa·	0	9	0	9	0
ʔuyi	0	13	0	13	0
waɬaːk	0	5	0	5	0
quːʔas	35	1	0	36	0.11553716142688074
ʔaḥʔaː	14	32	0	46	0.559345027039261
čaːni	0	8	0	8	0
ʔu-ca	0	12	0	12	0
ʔaḥʔaː	14	33	0	47	0.5543818814751222
ʔaḥʔaː	15	33	0	48	0.5653371812436326
hiɬ	7	13	0	20	0.5893313279970291
ʔaḥ	22	2	1	25	0.4035151400004137
mamuːk	0	8	0	8	0
hiɬ	8	13	0	21	0.6048798520727897
c̓uʔičḥ	1	3	0	4	0.5118595071429148
mamuːk	0	9	0	9	0
c̓awaːk	1	3	0	4	0.5118595071429148
ʔu-na·k	0	18	0	18	0
waː	0	17	0	17	0
waː	0	18	0	18	0
čačim	1	10	0	11	0.2772917256537885
ɬuːcma	9	1	0	10	0.2959032742893846
ʔaƛa	0	3	1	4	0.5118595071429148
qʷis	6	18	0	24	0.5118595071429148
ƛaḥ	1	6	0	7	0.37330396038588737
ɬuːcma	10	1	0	11	0.2772917256537885
huḥtak	0	9	0	9	0
ʔaya	1	5	3	9	0.8527924884900405
ma-maɬ-n̓i·	5	0	0	5	0
ʔaḥʔaː	16	33	0	49	0.5749930206936642
qʷaː	17	41	0	58	0.550610190154848
huḥtak	0	10	0	10	0
wiːy̓a	0	7	0	7	0
ḥaːḥuːp	0	7	0	7	0
ʔu-kʷiɬ	0	8	0	8	0
ʔana	0	4	1	5	0.4554859150035953
ʔiːqḥ	0	5	0	5	0
ƛuɬ	1	4	0	5	0.4554859150035953
wa·	4	95	0	99	0.15403622626857855
yaqʷ-(č)iɬ	5	1	0	6	0.41011848630651815
waː	0	19	0	19	0
ʔaḥʔaː	16	34	0	50	0.5706011702567104
huḥtak	0	11	0	11	0
t̓uḥc̓iti	7	2	0	9	0.48215936096968104
ḥuːɬ	0	5	0	5	0
wa·	4	96	0	100	0.15286935115005695
y̓uːqʷaː	0	20	0	20	0
wa·	4	97	0	101	0.1517218271615038
hiɬ	9	13	0	22	0.6158004670725817
ʔaḥʔaː	17	34	0	51	0.579380164285695
wiːy̓a	0	8	0	8	0
sa-štu·p	4	0	0	4	0
ʔaḥ	23	2	1	26	0.3923778268231291
ʔu-ca-ḥta	0	5	0	5	0
n̓aːcsiː	0	5	0	5	0
čakup	4	0	0	4	0
wik	0	53	0	53	0
kuːkuḥʷʼisa	3	1	0	4	0.5118595071429148
čakup	5	0	0	5	0
n̓aːcsiː	0	6	0	6	0
qʷayac̓iːk	4	0	0	4	0
kuːkuḥʷʼisa	4	1	0	5	0.4554859150035953
hiniːc	0	4	0	4	0
ʔu-ca	0	13	0	13	0
kuːkuḥʷʼisa	5	1	0	6	0.41011848630651815
qʷayac̓iːk	5	0	0	5	0
ḥuː	2	6	0	8	0.5118595071429148
wik	0	54	0	54	0
naːw̓aḥi	0	4	0	4	0
čakup	6	0	0	6	0
ʔu-ca-ḥta·k	0	4	0	4	0
kuːkuḥʷʼisa	6	1	0	7	0.37330396038588737
hiniːc	0	5	0	5	0
waɬ	0	8	0	8	0
ɬuːcma	11	1	0	12	0.26108936338578836
qʷayac̓iːk	6	0	0	6	0
hiniːc	0	6	0	6	0
kuːkuḥʷʼisa	7	1	0	8	0.34295098019812786
yaq	13	0	0	13	0
haʔum	3	1	0	4	0.5118595071429148
ʔu-ca-ḥta·k	0	5	0	5	0
hiɬ-ʼatḥ	6	2	0	8	0.5118595071429148
čakup	7	0	0	7	0
hiɬ-ʼatḥ	7	2	0	9	0.48215936096968104
čakup	8	0	0	8	0
hiɬ	10	13	0	23	0.6231645912420037
qʷayac̓iːk	7	0	0	7	0
čakup	9	0	0	9	0
ʔuyi	0	14	0	14	0
ɬuːcma	12	1	0	13	0.2468472051870251
wik	0	55	0	55	0
ʔuḥ	0	13	0	13	0
kuːkuḥʷʼisa	8	1	0	9	0.3175206571427802
ʔuyi	0	15	0	15	0
čakup	10	0	0	10	0
hiɬ-ʼatḥ	8	2	0	10	0.4554859150035953
sukʷi(ƛ)	0	4	0	4	0
hiniːc	0	7	0	7	0
ʔu-ḥta·	0	4	0	4	0
qaḥ	1	3	0	4	0.5118595071429148
nay̓iːk	0	5	0	5	0
ʔaƛa	0	3	2	5	0.6126016192893443
qʷayac̓iːk	8	0	0	8	0
nay̓iːk	0	6	0	6	0
wik	0	56	0	56	0
qʷayac̓iːk-štaqumɬ	13	0	0	13	0
čuː	0	21	0	21	0
wa·	4	98	0	102	0.15059315992801106
čakup	11	0	0	11	0
wik	0	57	0	57	0
t̓apat	0	7	0	7	0
ʔu-n̓a·ḥ	0	9	0	9	0
qʷis	6	19	0	25	0.5016145675514594
čakup	12	0	0	12	0
wa·	5	98	0	103	0.17677272900480562
qʷayac̓iːk	9	0	0	9	0
ʔaḥʔaː	18	34	0	52	0.5871344771302647
wiːy̓a	0	9	0	9	0
haʔum	4	1	0	5	0.4554859150035953
maːʔak	5	0	0	5	0
maːʔak	6	0	0	6	0
his-taq	0	6	0	6	0
quːʔas	36	1	0	37	0.11309798613327456
n̓aːcsa	0	10	0	10	0
ʔaʔum	0	4	0	4	0
čuː	0	22	0	22	0
quːʔas	37	1	0	38	0.11076919850004079
ƛ̓aq	0	4	0	4	0
ʔuyi	0	16	0	16	0
maːʔak	7	0	0	7	0
his-taq	0	7	0	7	0
maːʔak	8	0	0	8	0
maːʔak	9	0	0	9	0
qʷaː	18	41	0	59	0.559898374040266
quːʔas	38	1	0	39	0.10854323006054539
maːʔak	10	0	0	10	0
ʔuːš-yuːya	0	10	0	10	0
wik̓iːt	0	10	0	10	0
y̓uːqʷaː	0	21	0	21	0
qʷaː	19	41	0	60	0.5682908456525204
quːʔas	39	1	0	40	0.10641319994632664
čuː	0	23	0	23	0
yaːc	0	4	0	4	0
yaːc	0	5	0	5	0
maʔas	4	0	0	4	0
ʔu-n̓a·ḥ	0	10	0	10	0
quːʔas	40	1	0	41	0.10437283779332174
huːʔak	0	16	0	16	0
quːʔas	41	1	0	42	0.10241641685625666
wik̓iːt	0	11	0	11	0
ʔu-ktis	0	5	0	5	0
hupaɬ	10	0	0	10	0
čuː	0	24	0	24	0
ʔaya	1	6	3	10	0.8173454221465103
kʷis-ca	0	5	0	5	0
his-taq	0	8	0	8	0
ʔu-ca	0	14	0	14	0
his-taq	0	9	0	9	0
ʕaːḥuːsʔatḥ	4	0	0	4	0
ʔaḥ	23	3	1	27	0.45766125575532474
t̓aːtn̓a	5	0	0	5	0
ʔu-ca	0	15	0	15	0
hiɬ	10	14	0	24	0.6182283531662822
ʔaḥ	23	3	2	28	0.5364959133847247
ʔu-ḥʷʼaɬ	0	10	0	10	0
ciq-y̓akʷ	4	0	0	4	0
niːw̓a	4	0	0	4	0
hiɬ-ʼatḥ	9	2	0	11	0.43158020163114585
y̓uːqʷaː	0	22	0	22	0
t̓aːtn̓a	6	0	0	6	0
čuː	0	25	0	25	0
ʔaḥʔaː	19	34	0	53	0.5939718496548864
ƛaḥ	1	7	0	8	0.34295098019812786
kaƛḥ	3	1	0	4	0.5118595071429148
ʔu-n̓a·ḥ	0	11	0	11	0
huʔa-ca	0	8	0	8	0
wik	0	58	0	58	0
y̓uːqʷaː	0	23	0	23	0
t̓aːtn̓a	7	0	0	7	0
naʔa·	0	10	0	10	0
ʔunw̓iːƛ	0	9	0	9	0
ʔu-kʷiɬ	0	9	0	9	0
huḥtak	0	12	0	12	0
ʔu-y̓i·ḥa	0	4	0	4	0
ʔan	0	4	0	4	0
wik	0	59	0	59	0
niːw̓a	5	0	0	5	0
čuː	0	26	0	26	0
ciq-y̓akʷ	5	0	0	5	0
čuː	0	27	0	27	0
qiː	0	16	0	16	0
qʷis	6	20	0	26	0.4917150007886507
ʔaḥ	24	3	2	29	0.5240515878248748
qʷiyu	10	1	0	11	0.2772917256537885
n̓aːs	4	0	0	4	0
ʔu-kɬa·	0	8	0	8	0
y̓uːqʷaː	0	24	0	24	0
wik	0	60	0	60	0
ʔaƛa	0	4	2	6	0.579380164285695
yaq	14	0	0	14	0
ʔaya	1	6	4	11	0.8342022886441015
mamaɬn̓i	5	0	0	5	0
ciq-y̓akʷ	6	0	0	6	0
ʔuːš	6	4	3	13	0.9629470156266078
ʔaḥ	25	3	2	30	0.5122187561880756
ʔu-n̓a·ḥ	0	12	0	12	0
wa·	5	99	0	104	0.17550636548178714
waː	0	20	0	20	0
ḥaːɬ	1	2	1	4	0.9463946303571862
his-taq	1	9	0	10	0.2959032742893846
hap-tu·p	4	0	0	4	0
wa·	5	100	0	105	0.17425991310347752
ʔuḥ	0	14	0	14	0
wa·	5	101	0	106	0.17303288937467548
waː	0	21	0	21	0
čuː	0	28	0	28	0
ʔu-na·k	0	19	0	19	0
yaqʷ-(č)iɬ	6	1	0	7	0.37330396038588737
wa·	5	102	0	107	0.17182482752000441
qʷiq	4	0	0	4	0
quːʔas	42	1	0	43	0.10053869578184364
čaːni	0	9	0	9	0
mamaɬn̓i	5	1	0	6	0.41011848630651815
naq	0	5	0	5	0
č̓aʔak	4	0	0	4	0
ʔuːš-yuːya	0	11	0	11	0
ʔaḥʔaː	20	34	0	54	0.5999864653089827
naq	0	6	0	6	0
mamaɬn̓i	6	1	0	7	0.37330396038588737
waː	0	22	0	22	0
qʷaː	19	42	0	61	0.5645996232714611
quːʔas	43	1	0	44	0.09873486775522972
waː	0	23	0	23	0
waː	0	24	0	24	0
ʔuːš-ckʷi·	0	4	0	4	0
naʔa·	0	11	0	11	0
wa·	5	103	0	108	0.17063527584369412
čuː	0	29	0	29	0
hin-a·či(ƛ)	0	4	0	4	0
his-taq	1	10	0	11	0.2772917256537885
ʔu-na·k	0	20	0	20	0
wik-sa	0	5	0	5	0
ʔiːqḥ	0	6	0	6	0
yaq	15	0	0	15	0
hicnup	3	1	0	4	0.5118595071429148
nay̓iːk	0	7	0	7	0
kʷis-ca	0	6	0	6	0
ɬuːcma	13	1	0	14	0.2342215203652865
kʷis-ca	0	7	0	7	0
čakup	13	0	0	13	0
quːʔas	44	1	0	45	0.09700051594836433
č̓uš	0	4	0	4	0
ʔana-siɬa	0	7	0	7	0
k̓acḥaq	4	0	0	4	0
k̓acḥaq	5	0	0	5	0
wik	0	61	0	61	0
ʔiːqḥ	0	7	0	7	0
wa·	5	104	0	109	0.1694637971205072
huːʔak	0	17	0	17	0
ʔuːš-yuːya	0	12	0	12	0
ḥaw̓iɬ	18	4	0	22	0.43158020163114585
ʕiḥ	0	5	0	5	0
ɬuːcma	14	1	0	15	0.22294491816723944
ʕiḥ	0	6	0	6	0
ʔaːʔaːʔiša	0	5	0	5	0
wa·	5	105	0	110	0.1683099680160561
čakup	14	0	0	14	0
č̓apac	29	1	0	30	0.1330266805824107
ƛiḥ	0	5	0	5	0
waː	0	25	0	25	0
čačim	1	11	0	12	0.26108936338578836
čaːni	0	10	0	10	0
wa·	5	106	0	111	0.16717337853486822
nay̓iːk	0	8	0	8	0
nay̓iːk	0	9	0	9	0
quːʔas	45	1	0	46	0.09533157437375632
nay̓iːk	0	10	0	10	0
ʔuːš-su·qstu(ƛ)	0	4	0	4	0
ƛiḥ	0	6	0	6	0
wa·	5	107	0	112	0.16605363149466162
maːqtusiːs	4	0	0	4	0
qʷiq	5	0	0	5	0
hiɬ	10	15	0	25	0.6126016192893443
ʔu-kɬa·	0	9	0	9	0
čuː	0	30	0	30	0
ʔuḥ	0	15	0	15	0
ʔaḥ	25	4	2	31	0.559363613011501
hiɬ	10	16	0	26	0.6064727741416686
wik	0	62	0	62	0
wik	0	63	0	63	0
wik	0	64	0	64	0
qʷis	7	20	0	27	0.5209123406908595
ʕaːḥuːsʔatḥ	5	0	0	5	0
wik	0	65	0	65	0
ʔunic	0	5	0	5	0
ʔunic	1	5	0	6	0.41011848630651815
č̓apac	30	1	0	31	0.1297144305253523
čuː	0	31	0	31	0
čuː	0	32	0	32	0
ƛiḥ	0	7	0	7	0
čačim	1	12	0	13	0.2468472051870251
qʷaː	19	43	0	62	0.560918572778773
ʔunic	2	5	0	7	0.5445684476282008
ʕaːḥuːsʔatḥ	6	0	0	6	0
wič-siɬa	0	4	0	4	0
quːʔas	46	1	0	47	0.09372429339038518
ʔiːnax-yu·	0	4	0	4	0
n̓aːcsiː	0	7	0	7	0
quːʔas	47	1	0	48	0.09217520922650448
n̓aːcsiː	0	8	0	8	0
yaq	16	0	0	16	0
ḥaw̓iɬ	19	4	0	23	0.420564119145802
yaq	17	0	0	17	0
ḥaw̓iɬ	20	4	0	24	0.41011848630651815
ʔaḥʔaː	21	34	0	55	0.605261027701217
ʔuyi	0	17	0	17	0
wa·	5	108	0	113	0.16495034202538855
waː	0	26	0	26	0
ʔaḥʔaː	22	34	0	56	0.6098684556311537
ʔu-kɬa·	0	10	0	10	0
ʔuḥ	0	16	0	16	0
ʔaḥʔaː	23	34	0	57	0.6138732784821117
yaq	18	0	0	18	0
wik	0	66	0	66	0
quːʔas	48	1	0	49	0.09068111698162357
wa·	5	109	0	114	0.16386313709169492
ʔuyi	0	18	0	18	0
ƛiḥ	0	8	0	8	0
qʷiyu	11	1	0	12	0.26108936338578836
siːk	0	4	0	4	0
ʔuʔumḥi	0	7	0	7	0
c̓iːq	1	3	0	4	0.5118595071429148
kʷaːtya	4	0	0	4	0
wa·	5	110	0	115	0.16279165503752757
wa·	5	111	0	116	0.16173554515169894
wa·	5	112	0	117	0.1606944672532896
ʔaya	2	6	4	12	0.9206198357143052
ʔu-ca	0	16	0	16	0
ʕaːḥuːsʔatḥ	7	0	0	7	0
ʕaːḥuːsʔatḥ	8	0	0	8	0
ʔaḥʔaː	24	34	0	58	0.6173327941976077
ḥaw̓iɬ	20	5	0	25	0.4554859150035953
yaqʷ-(č)iɬ	7	1	0	8	0.34295098019812786
wa·	5	113	0	118	0.1596680912958405
ƛaḥ-aqsak	4	0	0	4	0
ʔaḥ	26	4	2	32	0.5478948105177536
ʕaːḥuːsʔatḥ	9	0	0	9	0
quːʔas	49	1	0	50	0.08923904665092416
ʔaƛa	0	5	2	7	0.5445684476282008
ʔu-ca	0	17	0	17	0
n̓aːcsa	0	11	0	11	0
nay̓iːk	0	11	0	11	0
hiɬ	10	17	0	27	0.5999864653089827
ʔu-ca	0	18	0	18	0
wa·	5	114	0	119	0.15865609698934469
ʔu-kɬa·	0	11	0	11	0
yaq	19	0	0	19	0
qaːḥma	4	0	0	4	0
ʔaƛa	1	5	2	8	0.8194483718728036
ʔaḥʔaː	25	34	0	59	0.6202980371970669
ƛ̓i	0	4	0	4	0
ʔana	0	5	1	6	0.41011848630651815
k̓acḥaq	6	0	0	6	0
ƛ̓i	0	5	0	5	0
mamaɬn̓i	7	1	0	8	0.34295098019812786
ʔaːḥʔasa	0	4	0	4	0
yaq	20	0	0	20	0
ḥaːɬ	1	3	1	5	0.8649735207179273
nism̓a	4	0	0	4	0
huḥtak	0	13	0	13	0
qaːḥma	5	0	0	5	0
yack	0	4	0	4	0
hiɬ-ʼa·ʔa	2	2	0	4	0.6309297535714575
piḥ	0	7	0	7	0
ka	0	4	0	4	0
quːʔas	50	1	0	51	0.08784624178284851
wik	0	67	0	67	0
wik	0	68	0	68	0
hiš	1	2	1	4	0.9463946303571862
qaːḥma	6	0	0	6	0
ƛ̓i	0	6	0	6	0
wik	0	69	0	69	0
tiːč	0	4	0	4	0
ʔu-ca	0	19	0	19	0
ḥuːɬ	0	6	0	6	0
čuː	0	33	0	33	0
wa·	5	115	0	120	0.15765817343911248
yaq	21	0	0	21	0
quːʔas	51	1	0	52	0.08650014043703722
naʔi·qsu	4	0	0	4	0
yaqʷ	6	0	0	6	0
naniːqsu	3	1	0	4	0.5118595071429148
kʷaːtya	5	0	0	5	0
mač	0	6	0	6	0
sukʷi(ƛ)	0	5	0	5	0
ƛaʔuːkʷiʔatḥ	4	0	0	4	0
wa·	5	116	0	121	0.1566740188006346
kaʔup	0	4	0	4	0
hayim	0	4	0	4	0
hiɬ	11	17	0	28	0.6098684556311537
wa·	5	117	0	122	0.15570333994962157
minwaːʔath	4	0	0	4	0
maḥt̓iː	4	0	0	4	0
wik̓iːt	0	12	0	12	0
č̓apac	31	1	0	32	0.12657859363955407
qum̓aː	3	1	0	4	0.5118595071429148
ʔuʔumḥi	0	8	0	8	0
quːʔas	52	1	0	53	0.08519835815717174
č̓apac	32	1	0	33	0.12360498799464747
n̓aːcsa	0	12	0	12	0
qʷaː	20	43	0	63	0.5688451524849609
n̓aːcsa	0	13	0	13	0
ʔu-ca	0	20	0	20	0
ʔu-kɬa·	0	12	0	12	0
ʔaḥ	27	4	2	33	0.5369220496830904
muːɬ	1	4	0	5	0.4554859150035953
muːɬ	2	4	0	6	0.579380164285695
hapt	1	3	0	4	0.5118595071429148
ḥuːɬ	0	7	0	7	0
ʔaḥʔaː	26	34	0	60	0.6228145927257205
hapt	1	4	0	5	0.4554859150035953
hiɬ-ʼatḥ	9	3	0	12	0.5118595071429148
č̓itaːpi	4	0	0	4	0
ƛ̓i	0	7	0	7	0
k̓aḥ-kʷa	0	4	0	4	0
č̓apac	33	1	0	34	0.1207809362853011
ʔaḥʔaː	27	34	0	61	0.624923286083023
wa·	5	118	0	123	0.1547458521664448
c̓awaːk	1	3	1	5	0.8649735207179273
qʷis	7	21	0	28	0.5118595071429148
ʔinkʷ	12	2	0	14	0.37330396038588737
ʔinkʷ	12	3	0	15	0.4554859150035953
maḥt̓iː	5	0	0	5	0
ʔu-ca	0	21	0	21	0
maːqtusiːs	5	0	0	5	0
ʕaːḥuːsʔatḥ	10	0	0	10	0
yaqʷ-(č)iɬ	8	1	0	9	0.3175206571427802
wa·	5	119	0	124	0.15380127883425043
ʔu-ca	0	22	0	22	0
ƛ̓i	0	8	0	8	0
wik	0	70	0	70	0
wa·	5	120	0	125	0.15286935115005695
quːʔas	53	1	0	54	0.08393867271318158
qʷaː	21	43	0	64	0.5760383688382746
maḥt̓iː	6	0	0	6	0
wik̓iːt	0	13	0	13	0
maḥt̓iː	7	0	0	7	0
hiš	1	2	2	5	0.9602297178607614
č̓apac	34	1	0	35	0.11809506962344107
ƛaʔuː	5	3	1	9	0.8527924884900406
wa·	5	121	0	126	0.1519498078481888
y̓uːqʷaː	0	25	0	25	0
sukʷi(ƛ)	0	6	0	6	0
ʔu-iːc	0	4	0	4	0
t̓an̓a	4	0	0	4	0
huʔa-ca	0	9	0	9	0
ƛaʔuːkʷiʔatḥ	5	0	0	5	0
yaq	22	0	0	22	0
ʕaːḥuːsʔatḥ	11	0	0	11	0
ḥamip	0	4	0	4	0
huʔa-ca	0	10	0	10	0
waɬaːk	0	6	0	6	0
hin-a·či(ƛ)	0	5	0	5	0
ƛaʔuːkʷiʔatḥ	6	0	0	6	0
hin-a·či(ƛ)	0	6	0	6	0
minwaːʔath	5	0	0	5	0
ḥamip	0	5	0	5	0
yaq	23	0	0	23	0
miːmixt	4	0	0	4	0
ʔu-kɬa·	0	13	0	13	0
n̓aːcsa	0	14	0	14	0
ʔu-kɬa·	0	14	0	14	0
ḥaw̓iɬ	21	5	0	26	0.4456093370450385
ƛaʔuːkʷiʔatḥ	7	0	0	7	0
wa·	5	122	0	127	0.15104239493543567
sukʷi(ƛ)	0	7	0	7	0
miːmixt	5	0	0	5	0
c̓awaːk	1	4	1	6	0.7896900821428475
ʔiːč̓im	2	2	0	4	0.6309297535714575
wa·	5	123	0	128	0.15014686543735722
ḥaːw̓iɬaƛ	2	2	0	4	0.6309297535714575
sukʷi(ƛ)	0	8	0	8	0
waː	0	27	0	27	0
mixt	2	2	0	4	0.6309297535714575
naq	0	7	0	7	0
qʷaː	21	44	0	65	0.5726925179288707
ʔaḥ	28	4	2	34	0.5264143616682584
quːʔas	54	1	0	55	0.08271901040099797
qaḥ	1	4	0	5	0.4554859150035953
wa·	5	124	0	129	0.14926297915519182
ʔuːš-yuːya	0	13	0	13	0
naq	0	8	0	8	0
waɬaːk	0	7	0	7	0
siːk	0	5	0	5	0
siːk	0	6	0	6	0
ƛiḥ	0	9	0	9	0
wa·	5	125	0	130	0.14839050243285176
ƛiḥ	0	10	0	10	0
qʷaː	21	45	0	66	0.5693467715383745
wa·	5	126	0	131	0.14752920793351973
minwaːʔath	6	0	0	6	0
wa·	5	127	0	132	0.1466788744253878
yaq	24	0	0	24	0
wa·	5	128	0	133	0.14583928657610218
ƛaḥ	1	8	0	9	0.3175206571427802
waː	0	28	0	28	0
quːʔas	55	1	0	56	0.08153743371662339
ʔu-y̓i·ḥa	0	5	0	5	0
ʔu-na·k	0	21	0	21	0
ʔu-na·k	0	22	0	22	0
ḥaw̓iɬ	21	6	0	27	0.48215936096968104
yaq	25	0	0	25	0
kapčaː	4	0	0	4	0
ʔu-na·k	0	23	0	23	0
ʔu-(y)i·	0	4	0	4	0
ʔaqi-ʔišt	11	0	0	11	0
qʷis	7	22	0	29	0.503057018563316
qʷis	8	22	0	30	0.5278615371407821
yaq	26	0	0	26	0
ʔu-kʷiɬ	0	10	0	10	0
quːʔas	56	1	0	57	0.08039213024559477
waɬaːk	0	8	0	8	0
huʔa-ca	0	11	0	11	0
qʷaː	22	45	0	67	0.5761903900026336
ʔat	0	4	0	4	0
waː	0	29	0	29	0
ʔuːš-yuːya	0	14	0	14	0
ʔin	0	4	0	4	0
ʔana	0	5	2	7	0.5445684476282008
minwaːʔath	7	0	0	7	0
wa·	5	129	0	134	0.14501023475550406
ʔu-ʼi·c	0	4	0	4	0
ʔu-kʷiɬ	0	11	0	11	0
ʔu-ʼi·c	0	5	0	5	0
ʔaḥʔaː	28	34	0	62	0.6266607691272105
qʷis	8	23	0	31	0.5197672707950403
c̓awaːk	1	5	1	7	0.7248340915057601
ɬuːcma	15	1	0	16	0.21280633861277304
ɬuːcma	15	2	0	17	0.32969825740304703
ʔiːč̓im	2	3	0	5	0.6126016192893443
ʔaḥ	28	5	2	35	0.5643996045292355
t̓uḥc̓iti	8	2	0	10	0.4554859150035953
k̓aḥ-kʷa	0	5	0	5	0
y̓uːqʷaː	0	26	0	26	0
wik	0	71	0	71	0
huʔa-aːs	0	4	0	4	0
k̓ʷak̓ʷaƛ	4	0	0	4	0
wik	0	72	0	72	0
ɬač	0	4	0	4	0
ƛaʔuː	6	3	1	10	0.8173454221465102
qʷiq	6	0	0	6	0
yaq	27	0	0	27	0
quːʔas	57	1	0	58	0.07928140262964779
ʔaḥ	29	5	2	36	0.5542754815334214
yaqʷ-iɬ	4	0	0	4	0
qaḥ	1	5	0	6	0.41011848630651815
c̓awaːk	2	5	1	8	0.8194483718728036
qaḥ	1	6	0	7	0.37330396038588737
wa·	5	130	0	135	0.1441915148462777
ʔat	0	5	0	5	0
ʔaḥʔaː	29	34	0	63	0.6280600218572
čuː	0	34	0	34	0
qʷisḥ	2	2	0	4	0.6309297535714575
ʔu-qḥɬi	0	4	0	4	0
čuː	0	35	0	35	0
qaḥ	1	7	0	8	0.34295098019812786
nay̓iːk	0	12	0	12	0
wik	0	73	0	73	0
hiniːc	0	8	0	8	0
ʔu-ca	0	23	0	23	0
huʔa-ca	0	12	0	12	0
quːʔas	58	1	0	59	0.07820365949012077
ʔuḥ	0	17	0	17	0
yaqʷ	7	0	0	7	0
ʔu-ksnaʕaːɬ	0	5	0	5	0
yaqʷ	8	0	0	8	0
yaqʷ	9	0	0	9	0
huʔa-ca	0	13	0	13	0
ḥaː	7	5	0	12	0.6182283531662822
hiɬ	11	18	0	29	0.6041489835116367
ʔaḥʔaː	30	34	0	64	0.6291507833406458
nay̓iːk	0	13	0	13	0
wik̓iːt	0	14	0	14	0
haʔuk	0	7	0	7	0
hiniːc	0	9	0	9	0
waɬ	0	9	0	9	0
ʔuyi	0	19	0	19	0
ʔaḥʔaː	31	34	0	65	0.6299599235149622
ʔiːqḥ	0	8	0	8	0
čuː	0	36	0	36	0
ʔaḥ	29	5	3	37	0.6054162791696553
ʕimti·	4	0	0	4	0
wik	0	74	0	74	0
ʔu-ḥʷʼaɬ	0	11	0	11	0
ʔaḥ	29	5	4	38	0.6463735222028193
nuːk	3	1	0	4	0.5118595071429148
wik	0	75	0	75	0
kuw̓iɬa	0	4	0	4	0
ʔu-ḥʷʼaɬ	0	12	0	12	0
ʕimti·	5	0	0	5	0
qʷiq	7	0	0	7	0
ʕimti·	6	0	0	6	0
wik	0	76	0	76	0
kuw̓iɬa	0	5	0	5	0
ʔu-ḥʷʼaɬ	0	13	0	13	0
muː-qʔičḥ	2	2	0	4	0.6309297535714575
ʔunic	3	5	0	8	0.6021808102656679
huʔa-aːs	0	5	0	5	0
nuːk	4	1	0	5	0.4554859150035953
huʔa-aːs	0	6	0	6	0
ʔu-ḥʷʼaɬ	0	14	0	14	0
ʕimti·	7	0	0	7	0
ʔaḥʔaː	32	34	0	66	0.6305117652399898
qʷaː	22	46	0	68	0.5729967408607366
huːʔak	0	18	0	18	0
ʔuyi	0	20	0	20	0
qiː	0	17	0	17	0
huːʔak	0	19	0	19	0
waː	0	30	0	30	0
ḥuː	2	7	0	9	0.48215936096968104
ʔaḥ	30	5	4	39	0.6360148563742586
yaqʷ-(č)iɬ	8	2	0	10	0.4554859150035953
ma-maɬ-n̓i·	6	0	0	6	0
waː	0	31	0	31	0
n̓aːcsa	0	15	0	15	0
quːʔas	59	1	0	60	0.07715740720284056
ƛ̓up	0	4	0	4	0
ɬuːcsaːmiːḥ	4	0	0	4	0
n̓aːcsa	0	16	0	16	0
ḥuːɬ	0	8	0	8	0
ʔaḥ	31	5	4	40	0.6259990012540807
qʷaː	22	47	0	69	0.5698028639453333
ʔaḥ	32	5	4	41	0.616310522029846
qʷis	8	24	0	32	0.5118595071429148
ʔaḥ	33	5	4	42	0.6069346739848357
waː	0	32	0	32	0
ʔaḥ	34	5	4	43	0.5978574044716777
čuː	0	37	0	37	0
wik	0	77	0	77	0
hapt	1	5	0	6	0.41011848630651815
quːʔas	60	1	0	61	0.07614124243230619
n̓aːcsa	0	17	0	17	0
wik	0	78	0	78	0
huḥtak	0	14	0	14	0
ʔuḥ	0	18	0	18	0
n̓aːcsa	0	18	0	18	0
quːʔas	61	1	0	62	0.07515384534425938
ciq	1	6	0	7	0.37330396038588737
waː	0	33	0	33	0
ʔaḥ	35	5	4	44	0.589065344015723
c̓awaːk	2	6	1	9	0.7725068857142602
yaːc	0	6	0	6	0
waː	0	34	0	34	0
yaːc	0	7	0	7	0
ʔaḥ	36	5	4	45	0.5805457898444555
nism̓a	5	0	0	5	0
yaqʷ-(č)iɬ	8	3	0	11	0.5333570581245947
mamaɬn̓i	8	1	0	9	0.3175206571427802
waː	0	35	0	35	0
yaːc	0	8	0	8	0
naʔa·	0	12	0	12	0
qʷiq	7	1	0	8	0.34295098019812786
waː	0	36	0	36	0
qʷis	8	25	0	33	0.5041434864740977
yaːc	0	9	0	9	0
wik	0	79	0	79	0
wiːy̓a	0	10	0	10	0
yaːc	0	10	0	10	0
qʷaː	23	47	0	70	0.5763291843443233
quːʔas	62	1	0	63	0.07419397342546548
qʷaː	23	48	0	71	0.5732745081524037
ʔaḥʔaː	33	34	0	67	0.630828364283775
c̓aʔak	3	1	0	4	0.5118595071429148
n̓aːcsiː	0	9	0	9	0
qʷaː	23	49	0	72	0.5702193508195721
ʔaya	2	7	4	13	0.8956403056385982
ḥaː	7	6	0	13	0.6282340759682774
ḥaːɬ	1	4	1	6	0.7896900821428475
qum̓aː	4	1	0	5	0.4554859150035953
maḥt̓iː	7	1	0	8	0.34295098019812786
ʔu-n̓a·ḥ	0	13	0	13	0
ʔuːš-yuːya	0	15	0	15	0
waː	0	37	0	37	0
č̓aːstimc-m̓i·t	4	0	0	4	0
ʔaḥ	37	5	4	46	0.5722866842883071
ʔuːš-yuːya	0	16	0	16	0
waː	0	38	0	38	0
waː	0	39	0	39	0
ƛimk	0	4	0	4	0
quːʔas	62	2	0	64	0.12657859363955407
ḥaːɬ	1	5	1	7	0.7248340915057601
ʔiːḥ	0	3	1	4	0.5118595071429148
wim̓aːqƛ	0	9	0	9	0
ʔin	0	5	0	5	0
wim̓aːqƛ	0	10	0	10	0
ʔu-ʼiːḥ	0	10	0	10	0
t̓aps	0	4	0	4	0
hin-in	0	7	0	7	0
naʔaː	0	4	0	4	0
ḥaː	7	7	0	14	0.6309297535714575
y̓uːqʷaː	0	27	0	27	0
wik	0	80	0	80	0
waː	0	40	0	40	0
hin-in	0	8	0	8	0
qʷayac̓iːk	10	0	0	10	0
č̓aːstimc-m̓i·t	5	0	0	5	0
ʔu-y̓i·ḥa	0	6	0	6	0
wik	0	81	0	81	0
wik	0	82	0	82	0
haʔuk	0	8	0	8	0
waʔič	0	4	0	4	0
waː	0	41	0	41	0
huḥtak	0	15	0	15	0
sukʷiƛ	0	5	0	5	0
ʔaḥ	37	5	5	47	0.6053787168423883
qaḥ	1	8	0	9	0.3175206571427802
ʔin	0	6	0	6	0
ʔiːḥ	0	4	1	5	0.4554859150035953
ʔiːḥ	0	5	1	6	0.41011848630651815
ʔin	0	7	0	7	0
ʔana	0	6	2	8	0.5118595071429148
ʔiːḥ	0	6	1	7	0.37330396038588737
t̓uḥc̓iti	9	2	0	11	0.43158020163114585
hapt	1	6	0	7	0.37330396038588737
hiʔiːs	0	4	0	4	0
hiʔiːs	1	4	0	5	0.4554859150035953
hiɬ	11	19	0	30	0.598170772597163
ʔaḥ	37	5	6	48	0.6336770586796948
qʷayaːc̓ik-m̓i·t	4	0	0	4	0
wik	0	83	0	83	0
waː	0	42	0	42	0
qaḥ	1	9	0	10	0.2959032742893846
wawaː	2	15	0	17	0.32969825740304703
wik	0	84	0	84	0
c̓awaːk	2	7	1	10	0.7298466991620975
qʷayac̓iːk	11	0	0	11	0
maːsuːɬ	0	4	0	4	0
wik̓iːt	0	15	0	15	0
wik̓iːt	0	16	0	16	0
ʔu-na·k	0	24	0	24	0
č̓aːstimc-m̓i·t	6	0	0	6	0
ƛuɬ	1	5	0	6	0.41011848630651815
ḥaːɬ	1	6	1	8	0.6695919455357793
c̓aʔak	4	1	0	5	0.4554859150035953
wiːy̓a	0	11	0	11	0
qʷaː	23	50	0	73	0.5671665952974393
ʔaḥʔaː	34	34	0	68	0.6309297535714575
čuː	0	38	0	38	0
ciq	1	7	0	8	0.34295098019812786
ḥaw̓iɬ	22	6	0	28	0.472941950941057
qaḥ	1	10	0	11	0.2772917256537885
qʷayaːc̓ik-m̓i·t	5	0	0	5	0
wa·	5	131	0	136	0.14338292806213526
wa·	5	132	0	137	0.1425842807731924
hiʔiːs	1	5	0	6	0.41011848630651815
ḥaːɬ	1	7	1	9	0.6223659728744495
ḥaː	7	8	0	15	0.628905498728265
qaḥ	1	11	0	12	0.26108936338578836
qaḥ	1	12	0	13	0.2468472051870251
sut-(č)iɬ	0	8	0	8	0
wa·	5	133	0	138	0.14179538433820169
hapt	1	7	0	8	0.34295098019812786
ʔaqi-ʔišt	12	0	0	12	0
hapt	1	8	0	9	0.3175206571427802
ḥaː	7	9	0	16	0.6237998740277075
qaḥ	1	13	0	14	0.2342215203652865
qʷayaːc̓ik-m̓i·t	6	0	0	6	0
hapt	1	9	0	10	0.2959032742893846
qʷis	8	26	0	34	0.4966215830615092
wik̓iːt	0	17	0	17	0
ƛ̓up	0	5	0	5	0
ƛ̓up	0	6	0	6	0
qʷaː	23	51	0	74	0.5641188253586885
qʷayac̓iːk	12	0	0	12	0
čuː	0	39	0	39	0
wa·	5	134	0	139	0.14101605494333141
č̓aːstimc-x-m̓i·t	4	0	0	4	0
qaḥ	1	14	0	15	0.22294491816723944
wa·	5	135	0	140	0.14024611344719426
qʷis	8	27	0	35	0.48929401028749303
qʷaː	23	52	0	75	0.561078355054214
qʷis	8	28	0	36	0.48215936096968104
ʔaḥ	38	5	6	49	0.6255233470555788
ḥaːɬ	1	8	1	10	0.5816718657178869
wa·	5	136	0	141	0.1394853852318413
wa·	5	137	0	142	0.1387337000594561
wa·	5	138	0	143	0.13799089193449604
y̓uːqʷaː	0	28	0	28	0
qaḥ	2	14	0	16	0.34295098019812786
wa·	5	139	0	144	0.13725679897103682
c̓aʔak	5	1	0	6	0.41011848630651815
ʔaḥ	38	5	7	50	0.6499893723113671
ʔaya	2	7	5	14	0.903213977385558
ʔunw̓iːƛ	0	10	0	10	0
qʷayaːc̓ik-m̓i·t	7	0	0	7	0
t̓uḥc̓iti	10	2	0	12	0.41011848630651815
ʔu-ʼi·c	0	6	0	6	0
qʷaː	24	52	0	76	0.5676751079529517
haʔuk	0	9	0	9	0
qʷayac̓iːk	13	0	0	13	0
wiːy̓a	0	12	0	12	0
čuː	0	40	0	40	0
wa·	5	140	0	145	0.13653126326509574
wa·	5	141	0	146	0.13581413077171295
ʔu-na·k	0	25	0	25	0
nuːk	5	1	0	6	0.41011848630651815
wa·	5	142	0	147	0.13510525118658587
ʔana-iya	0	4	0	4	0
ʔana-iya	0	5	0	5	0
waː	0	43	0	43	0
wa·	5	143	0	148	0.13440447783206114
wik̓iːt	0	18	0	18	0
ƛaʔuː	7	3	1	11	0.7827759528141423
ʔana-iya	0	6	0	6	0
ʔana-iya	0	7	0	7	0
ʔana-iya	0	8	0	8	0
ʔana-iya	0	9	0	9	0
nunuːk	4	9	0	13	0.5618376711211267
ʔana-iya	0	10	0	10	0
qʷaː	24	53	0	77	0.5647532485394328
ʔana-iya	0	11	0	11	0
ʔana-iya	0	12	0	12	0
huyuːɬ	0	4	0	4	0
č̓aːstimc-m̓i·t	7	0	0	7	0
qʷayac̓iːk	14	0	0	14	0
hiʔiːs	1	6	0	7	0.37330396038588737
ḥaːɬ	1	9	1	11	0.5462947022805018
qʷayaːc̓ik-m̓i·t	8	0	0	8	0
kamatq	0	5	0	5	0
kamatq	0	6	0	6	0
c̓aʔak	6	1	0	7	0.37330396038588737
ʔana-iya	0	13	0	13	0
ʔana-iya	0	14	0	14	0
qʷis	8	29	0	37	0.4752150228959973
ʔaḥ	39	5	7	51	0.6420870779241639
sukʷiƛ	0	6	0	6	0
muːstati	4	0	0	4	0
k̓ʷač	0	4	0	4	0
ʔaḥ	40	5	7	52	0.634383082288562
kamatq	0	7	0	7	0
ʔaya	2	8	5	15	0.8830374409547586
kamatq	0	8	0	8	0
qʷayac̓iːk	15	0	0	15	0
č̓aːstimc	3	1	0	4	0.5118595071429148
č̓aːstimc-m̓i·t	8	0	0	8	0
ʔaḥ	41	5	7	53	0.6268706964492291
hinusa	0	4	0	4	0
ḥuː	2	8	0	10	0.4554859150035953
ḥuː	2	9	0	11	0.43158020163114585
hiɬ	11	20	0	31	0.5920110739569387
qʷayac̓iːk	16	0	0	16	0
ʔaya	2	9	5	16	0.8620485698650454
waː	0	44	0	44	0
wa·	5	144	0	149	0.13371166754729563
wa·	5	145	0	150	0.1330266805824107
wa·	5	146	0	151	0.1323493804964694
sus	0	4	0	4	0
qʷayac̓iːk	17	0	0	17	0
kamatq	0	9	0	9	0
ʔaya	2	10	5	17	0.8409160494198368
ʔu-kɬa·	0	15	0	15	0
kamatq	0	10	0	10	0
ʔu-(w)a(ƛ)	0	6	0	6	0
sukʷi(ƛ)	0	9	0	9	0
ʔaḥ	41	6	7	54	0.6536319318607747
ʔaḥʔaː	35	34	0	69	0.6308341569432563
qʷis	8	30	0	38	0.46845749928108243
c̓aʔak	7	1	0	8	0.34295098019812786
ʔiːḥʷ	0	2	2	4	0.6309297535714575
ʔuḥ	0	19	0	19	0
yaqʷ-(č)iɬ	9	3	0	12	0.5118595071429148
wa·	5	147	0	152	0.1316796340591176
sukʷi(ƛ)	0	10	0	10	0
qʷis	8	31	0	39	0.46188265637837134
ʔaḥʔaː	36	34	0	70	0.6305581767922107
nism̓a	5	1	0	6	0.41011848630651815
naʔaː	0	5	0	5	0
naʔaː	0	6	0	6	0
q̓ʷaːxtiː	4	0	0	4	0
wik	0	85	0	85	0
ʔu-ktis	0	6	0	6	0
q̓ʷaːxtiː	5	0	0	5	0
kamatq	0	11	0	11	0
qʷaː	24	54	0	78	0.5618376711211267
ʔaḥʔaː	37	34	0	71	0.6301169592410399
kamatq	0	12	0	12	0
č̓aːstimc-m̓i·t	9	0	0	9	0
ʔaḥ	41	7	7	55	0.6769553121788274
ʔu-ḥʷʼaɬ	0	15	0	15	0
qʷis	8	32	0	40	0.4554859150035953
ʔaḥ	42	7	7	56	0.6695919455357793
ʔu-kʷiɬ	0	12	0	12	0
ʔaḥ	43	7	7	57	0.6623918676383029
kamatq	0	13	0	13	0
muː-či·ɬ	2	2	0	4	0.6309297535714575
kamatq	0	14	0	14	0
wik	0	86	0	86	0
waʔič	0	5	0	5	0
sukʷi(ƛ)	0	11	0	11	0
ʔaḥ	44	7	7	58	0.6553504073564264
qʷis	8	33	0	41	0.4492623986791862
ʔaḥ	44	7	8	59	0.675944605000082
n̓aːcsa	0	19	0	19	0
ʔaḥ	44	8	8	60	0.696109471426504
kamatq	0	15	0	15	0
his-taq	1	11	0	12	0.26108936338578836
ʔaḥ	44	9	8	61	0.713991773109441
ʔaḥʔaː	37	35	0	72	0.6305785358552984
c̓aʔak	7	2	0	9	0.48215936096968104
kamatq	0	16	0	16	0
ƛawa-ʔiː	0	4	0	4	0
huḥtak	0	16	0	16	0
č̓aːstimc-m̓i·t	10	0	0	10	0
q̓ʷaːxtiː	6	0	0	6	0
qʷayac̓iːk	18	0	0	18	0
wa·	5	148	0	153	0.13101731115573312
ʔiːḥʷ	0	3	2	5	0.6126016192893443
kamatq	0	17	0	17	0
ʔaḥʔaː	37	36	0	73	0.6308443465816967
qʷayac̓iːk	19	0	0	19	0
naq	0	9	0	9	0
qʷayac̓iːk	20	0	0	20	0
qʷaː	24	55	0	79	0.5589302451290604
wiːy̓a	0	13	0	13	0
naq	0	10	0	10	0
kamatq	0	18	0	18	0
ʔaːḥʔasa	0	5	0	5	0
kamatq	0	19	0	19	0
č̓aːstimc-x-m̓i·t	5	0	0	5	0
qʷaː	24	56	0	80	0.5560326498763891
ʔaḥʔaː	38	36	0	74	0.6305972663272631
qum̓aː	4	2	0	6	0.579380164285695
nuːčyuː	2	2	0	4	0.6309297535714575
hupaɬ	11	0	0	11	0
hupaɬ	12	0	0	12	0
ʔaḥ	45	9	8	62	0.7072260218281223
ʔat	0	6	0	6	0
ʔu-cpa·	0	4	0	4	0
ʔaḥ	46	9	8	63	0.7005870040945256
hupaɬ	13	0	0	13	0
ʔaḥ	47	9	8	64	0.6940720100449542
ʔaḥ	48	9	8	65	0.6876783206301845
n̓aːcsa	0	20	0	20	0
hupaɬ	14	0	0	14	0
hiɬ	11	21	0	32	0.5857312535611813
kʷis	0	4	0	4	0
ʔaḥ	49	9	8	66	0.6814032209499236
n̓aːs	5	0	0	5	0
yaqʷ-(č)iɬ	10	3	0	13	0.4917150007886507
mamaɬn̓i	9	1	0	10	0.2959032742893846
wa·	5	149	0	154	0.13036228469594108
č̓aːstimc-m̓i·t	11	0	0	11	0
kamatq	0	20	0	20	0
qʷayac̓iːk	21	0	0	21	0
ʔat	0	7	0	7	0
nism̓a	6	1	0	7	0.37330396038588737
kamatq	0	21	0	21	0
čaːni	0	11	0	11	0
ƛimk	0	5	0	5	0
kamatq	0	22	0	22	0
his-i·k	2	2	0	4	0.6309297535714575
nuːčyuː	3	2	0	5	0.6126016192893443
c̓aʔak	8	2	0	10	0.4554859150035953
huḥtak	0	17	0	17	0
his-i·k	3	2	0	5	0.6126016192893443
ʔuːš-yuːya	0	17	0	17	0
ʔuːš-yuːya	0	18	0	18	0
qʷayac̓iːk	22	0	0	22	0
hayim	0	5	0	5	0
qʷaː	25	56	0	81	0.562536733469866
č̓aːstimc-m̓i·t	12	0	0	12	0
q̓ʷaːxtiː	7	0	0	7	0
ʔu-(w)a(ƛ)	0	7	0	7	0
ƛaʔuː	7	3	2	12	0.8734790278701757
qʷayac̓iːk	23	0	0	23	0
wik	0	87	0	87	0
ʔiːḥ	0	7	1	8	0.34295098019812786
qʷaː	26	56	0	82	0.5685750896865958
qʷayac̓iːk	24	0	0	24	0
qʷiq	8	1	0	9	0.3175206571427802
t̓aːtn̓a	7	1	0	8	0.34295098019812786
hiɬ-ʼa·ʔa	2	3	0	5	0.6126016192893443
ḥaː	7	10	0	17	0.6166819827494011
č̓aːstimc-m̓i·t	13	0	0	13	0
wa·	5	150	0	155	0.1297144305253523
wik	0	88	0	88	0
ʔu-kɬa·	0	16	0	16	0
wa·	5	151	0	156	0.12907362734039524
ʔu-kɬa·	0	17	0	17	0
ʕimti·	8	0	0	8	0
wa·	5	152	0	157	0.12843975660611429
wik	0	89	0	89	0
wik	0	90	0	90	0
wik	0	91	0	91	0
č̓aːstimc-m̓i·t	14	0	0	14	0
n̓aːcsiː	0	10	0	10	0
quːʔas	63	2	0	65	0.12507233704745038
qaḥ	2	15	0	17	0.32969825740304703
n̓aːcsiː	0	11	0	11	0
ḥaː	7	11	0	18	0.6082659775039311
qaḥ	2	16	0	18	0.3175206571427802
qaḥ	2	17	0	19	0.3062916381460314
q̓ʷaːxtiː	8	0	0	8	0
wa·	5	153	0	158	0.12781270247681417
qaḥ	2	18	0	20	0.2959032742893846
naʔaː	0	7	0	7	0
ƛatw̓a	0	4	0	4	0
č̓apac	35	1	0	36	0.11553716142688074
ʔu-na·k	0	26	0	26	0
qʷaː	26	57	0	83	0.565876405907631
y̓ak	1	3	0	4	0.5118595071429148
wa·	5	154	0	159	0.1271923517194359
wa·	5	155	0	160	0.12657859363955407
wa·	5	156	0	161	0.125971320009892
wa·	5	157	0	162	0.12537042500125464
č̓aːstimc-m̓i·t	15	0	0	15	0
huːʔak	0	19	1	20	0.1806963615767855
ʔaḥ	49	9	9	67	0.6991882861702522
ʔaya	2	11	5	18	0.8200425960260092
qaḥ	2	19	0	21	0.28626313807456294
waː	0	45	0	45	0
ʔu-kʷiɬ	0	13	0	13	0
qaḥ	2	20	0	22	0.2772917256537885
wa·	5	158	0	163	0.12477580511578311
wa·	5	159	0	164	0.12418735912244146
haʔuk	0	10	0	10	0
ʔaḥ	50	9	9	68	0.6930579045648105
waː	0	46	0	46	0
wik-sa	0	6	0	6	0
sut-(č)iɬ	0	9	0	9	0
wa·	5	160	0	165	0.12360498799464747
c̓awaːk	3	7	1	11	0.7827759528141423
wik̓iːt	0	19	0	19	0
wik-maɬ	0	4	0	4	0
ʔuːš-ckʷi·	0	5	0	5	0
qʷis	8	34	0	42	0.44320704809783756
ƛaʔuː	8	3	2	13	0.8420887815606471
wik	0	92	0	92	0
haʔuk	0	11	0	11	0
ʔaƛa	1	6	2	9	0.7725068857142602
ʔaḥ	51	9	9	69	0.687035365254027
qʷis	8	35	0	43	0.4373147093466981
huʔa-ca	0	14	0	14	0
kʷis-aqs	3	1	0	4	0.5118595071429148
č̓aːstimc-m̓i·t	16	0	0	16	0
ʔaḥʔaː	38	37	0	75	0.6308488410204711
wik	0	93	0	93	0
t̓an̓a	5	0	0	5	0
waː	0	47	0	47	0
muːḥinƛ-as	4	0	0	4	0
ḥaːɬ	1	10	1	12	0.5152734452350944
wawaː	2	16	0	18	0.3175206571427802
ʔuːš-yuːya	0	19	0	19	0
wik	0	94	0	94	0
ḥaːw̓iːḥaƛ	5	0	0	5	0
ḥaːw̓iːḥaƛ	6	0	0	6	0
c̓awaːk	3	8	1	12	0.7500000000000001
hita-inq-ʽsa(ƛ)	0	4	0	4	0
č̓aːstimc-m̓i·t	17	0	0	17	0
qʷaː	26	58	0	84	0.5631824178672722
t̓an̓a	6	0	0	6	0
hita-inq-ʽsa(ƛ)	0	5	0	5	0
q̓ʷaːxtiː	9	0	0	9	0
yaːc	0	11	0	11	0
yaːc	0	12	0	12	0
waː	0	48	0	48	0
ʔat	0	8	0	8	0
wiːy̓a	0	14	0	14	0
yaːc	0	13	0	13	0
qʷaː	26	59	0	85	0.5604946634260156
ʔaḥʔaː	39	37	0	76	0.6306145373956716
nay̓iːk	0	14	0	14	0
t̓an̓a	7	0	0	7	0
ʔuyaː-siɬa	0	4	0	4	0
č̓aːstimc-m̓i·t	18	0	0	18	0
muːḥinƛ-as	5	0	0	5	0
čuː	0	41	0	41	0
ʔac-yu·	0	9	0	9	0
č̓aːstimc-m̓i·t	19	0	0	19	0
muːɬ	2	5	0	7	0.5445684476282008
ʔana-iya	0	15	0	15	0
ḥuːɬ	0	9	0	9	0
ʔaya	2	11	6	19	0.8350554511591556
ʔuḥ	0	20	0	20	0
haʔum	5	1	0	6	0.41011848630651815
qʷaː	26	60	0	86	0.5578145360830786
t̓aps	0	5	0	5	0
č̓aːstimc	4	1	0	5	0.4554859150035953
n̓aːcsiː	0	12	0	12	0
ɬuːcma	16	2	0	18	0.3175206571427802
haʔuk	0	12	0	12	0
haʔuk	0	13	0	13	0
haʔuk	0	14	0	14	0
ʔu-ʼi·c	0	7	0	7	0
wa·	5	161	0	166	0.12302859484996514
wik̓iːt	0	20	0	20	0
wik̓iːt	0	21	0	21	0
t̓aps	0	6	0	6	0
t̓aps	0	7	0	7	0
ʔuyaː-siɬa	0	5	0	5	0
muːḥinƛ-as	6	0	0	6	0
qʷaː	26	61	0	87	0.5551432974075398
ƛiḥ	0	11	0	11	0
wik	0	95	0	95	0
saya-ʔiː	0	4	0	4	0
sut-(č)iɬ	0	10	0	10	0
wa·	5	162	0	167	0.12245808489177863
wa·	5	163	0	168	0.12189336535287332
ƛiḥ	0	12	0	12	0
muːḥinƛ-as	7	0	0	7	0
wik	0	96	0	96	0
saya-ʔiː	0	5	0	5	0
ḥaːɬ	1	10	2	13	0.6254181156238111
t̓an̓a	8	0	0	8	0
ʔu-kʷiɬ	0	14	0	14	0
ʔunaḥ	2	2	0	4	0.6309297535714575
maːmaːti	4	1	0	5	0.4554859150035953
mat	0	7	0	7	0
huːʔak	0	20	1	21	0.17425991310347752
ʔuyi	0	21	0	21	0
ʔu-qḥɬi	0	5	0	5	0
ḥuː	3	9	0	12	0.5118595071429148
nay̓aqak	3	1	0	4	0.5118595071429148
ʔuḥ	0	21	0	21	0
ḥaːkʷaːƛ	4	0	0	4	0
čuː	0	42	0	42	0
ƛ̓aq	0	5	0	5	0
ḥaːkʷa·ƛ	6	1	0	7	0.37330396038588737
ɬuːcma	16	3	0	19	0.3970120577425188
ʔuyi	0	22	0	22	0
ʔaḥʔaː	39	38	0	77	0.6308529897988518
hin-ʔaɬ	0	4	0	4	0
ɬuːcma	16	4	0	20	0.4554859150035953
maːtmaːs	4	0	0	4	0
hin-ʔaɬ	0	5	0	5	0
ɬuːcma	16	5	0	21	0.49960699524890273
hiɬ-ʼatḥ	10	3	0	13	0.4917150007886507
ḥaːkʷa·ƛ	7	1	0	8	0.34295098019812786
wik	0	97	0	97	0
n̓up-či·ɬ	2	2	0	4	0.6309297535714575
hupaɬ	15	0	0	15	0
qiː	0	18	0	18	0
c̓iːq	1	4	0	5	0.4554859150035953
ʔu-qḥɬi	0	6	0	6	0
qʷaː	27	61	0	88	0.5611908100400878
ḥaːkʷa·ƛ	8	1	0	9	0.3175206571427802
čuː	0	43	0	43	0
hiɬ-ʼatḥ	11	3	0	14	0.472941950941057
ḥaːkʷa·ƛ	9	1	0	10	0.2959032742893846
hiʔiːs	1	7	0	8	0.34295098019812786
ʔaḥʔaː	39	38	1	78	0.6852013686017302
c̓iːq	1	5	0	6	0.41011848630651815
ciq	1	8	0	9	0.3175206571427802
čuː	0	44	0	44	0
t̓apat	0	8	0	8	0
ḥaːkʷa·ƛ	10	1	0	11	0.2772917256537885
sukʷi(ƛ)	0	12	0	12	0
mač	0	7	0	7	0
wa·	5	164	0	169	0.12133434544084963
wik-ḥsa·	0	4	0	4	0
čuː	0	45	0	45	0
mač	0	8	0	8	0
wa·	5	165	0	170	0.1207809362853011
hiɬ-ʼatḥ	12	3	0	15	0.4554859150035953
ʔan	0	5	0	5	0
ʔi·ḥʷ	0	5	1	6	0.41011848630651815
maḥt̓iː	8	1	0	9	0.3175206571427802
hiːɬ	0	4	0	4	0
hiɬ-ʼatḥ	13	3	0	16	0.4392610297141858
hiːhiːq-šaḥap	0	4	0	4	0
nuːk	6	1	0	7	0.37330396038588737
nuːk	7	1	0	8	0.34295098019812786
ḥaːkʷa·ƛ	11	1	0	12	0.26108936338578836
ʔu-ca	0	24	0	24	0
ʔuyi	0	23	0	23	0
ʔaḥʔaː	39	39	1	79	0.6847369287136261
ʔiːqḥ	0	9	0	9	0
ʔaḥʔaː	39	40	1	80	0.6841363535446209
ḥaːkʷa·ƛ	12	1	0	13	0.2468472051870251
wa·	5	166	0	171	0.12023305088669055
čapxʷ-cuw̓at	4	0	0	4	0
ḥaːkʷa·ƛ	13	1	0	14	0.2342215203652865
ʔiːḥʷ	0	4	2	6	0.579380164285695
ʔuːš-yuːya	0	20	0	20	0
qʷayac̓iːk	25	0	0	25	0
ḥaːkʷa·ƛ	14	1	0	15	0.22294491816723944
naʔi·qsu	5	0	0	5	0
ḥaːkʷa·ƛ	15	1	0	16	0.21280633861277304
c̓iːq	1	6	0	7	0.37330396038588737
ḥaːkʷa·ƛ	16	1	0	17	0.20363696854060853
sukʷi(ƛ)	0	13	0	13	0
ʔu-ca	0	25	0	25	0
čapxʷ-cuw̓at	5	0	0	5	0
sukʷi(ƛ)	0	14	0	14	0
ʔuḥ	0	22	0	22	0
čapxʷ-cuw̓at	6	0	0	6	0
ʔumč̓aːp	1	3	0	4	0.5118595071429148
huːɬ	1	4	0	5	0.4554859150035953
ḥaːkʷa·ƛ	17	1	0	18	0.1953001594734786
nuːk	8	1	0	9	0.3175206571427802
čapxʷ-cuw̓at	7	0	0	7	0
huʔa-ca	0	15	0	15	0
ʔana-siɬa	0	8	0	8	0
ḥaːkʷa·ƛ	18	1	0	19	0.1876840927049947
ʔaḥʔaː	40	40	1	81	0.6836910800668649
qʷis	8	36	0	44	0.43158020163114585
huːʔak	0	21	1	22	0.1683099680160561
ʔuyi	0	24	0	24	0
kʷis-ca	0	8	0	8	0
ḥaːkʷa·ƛ	19	1	0	20	0.1806963615767855
ʔu-ca	0	26	0	26	0
hiɬ-ʼatḥ	14	3	0	17	0.42417080326490036
čakup	15	0	0	15	0
hiɬ	11	22	0	33	0.579380164285695
waɬ	0	10	0	10	0
ḥaːkʷa·ƛ	20	1	0	21	0.17425991310347752
t̓aːtn̓a	8	1	0	9	0.3175206571427802
ʔan	0	6	0	6	0
waɬ	0	11	0	11	0
ḥaːkʷa·ƛ	21	1	0	22	0.1683099680160561
huʔa-ca	0	16	0	16	0
ʔiːč̓um	4	0	0	4	0
huʔa-ca	0	17	0	17	0
ʔiːḥʷ	0	5	2	7	0.5445684476282008
ʔu-ḥʷʼaɬ	0	16	0	16	0
qʷayac̓iːk	26	0	0	26	0
huʔa-ca	0	18	0	18	0
hiɬ-ʼatḥ	15	3	0	18	0.41011848630651815
wik	0	98	0	98	0
ɬuč-na·k	0	4	0	4	0
ɬuč-na·k	0	5	0	5	0
ḥaːw̓iːḥaƛ	7	0	0	7	0
ʔaḥʔaː	41	40	1	82	0.6831161724681184
qʷaː	27	62	0	89	0.5586077756439064
ʔi·ḥʷ-camis	0	4	0	4	0
huʔa-ca	0	19	0	19	0
ḥaːkʷa·ƛ	22	1	0	23	0.16279165503752757
huʔa-ca	0	20	0	20	0
waɬ	0	12	0	12	0
wa·	5	167	0	172	0.11969060406685962
ʔu-ḥta·	0	5	0	5	0
ʔumʔi·qsu	11	0	0	11	0
wa·	5	168	0	173	0.1191535124211122
huḥtak	0	18	0	18	0
waɬ	0	13	0	13	0
wa·	5	169	0	174	0.11862169427181227
huʔa-ca	0	21	0	21	0
ʔan	0	7	0	7	0
ʔi·ḥʷ-camis	0	5	0	5	0
huḥtak	0	19	0	19	0
hihiq-tu·p	7	0	0	7	0
čuː	0	46	0	46	0
qʷis	8	37	0	45	0.4259983689447923
hiɬ	11	23	0	34	0.5729967408607366
hiɬ-ʼatḥ	16	3	0	19	0.3970120577425188
ʔaḥʔaː	42	40	1	83	0.6824213541500523
qʷis	8	38	0	46	0.420564119145802
ciq	1	9	0	10	0.2959032742893846
ʔunw̓iːƛ	0	11	0	11	0
kʷis-ca	0	9	0	9	0
ḥaːkʷa·ƛ	23	1	0	24	0.15765817343911248
ḥuː	3	10	0	13	0.4917150007886507
his-taq	1	12	0	13	0.2468472051870251
ƛaʔuːkʷiʔatḥ	8	0	0	8	0
ʔu-ca	0	27	0	27	0
qaːy̓uːk̓ʷatḥ	4	0	0	4	0
wik	0	99	0	99	0
ʔuḥ	0	23	0	23	0
ʔiːč̓um	5	0	0	5	0
čuː	0	47	0	47	0
ʔaḥʔaː	42	41	1	84	0.6821379619995858
qiː	0	19	0	19	0
huːʔak	0	22	1	23	0.16279165503752757
ʔu-kɬa·	0	18	0	18	0
ḥaːw̓iɬaƛ	3	2	0	5	0.6126016192893443
qʷiyu	12	1	0	13	0.2468472051870251
qʷis	8	39	0	47	0.4152724531424197
ʔaḥ	52	9	9	70	0.6811183751077099
his-taq	1	13	0	14	0.2342215203652865
nism̓a	7	1	0	8	0.34295098019812786
nism̓a	7	2	0	9	0.48215936096968104
ʔuḥ	0	24	0	24	0
ʔumʔi·qsu	11	1	0	12	0.26108936338578836
n̓uw̓i·qsu	1	3	0	4	0.5118595071429148
t̓an̓a	9	0	0	9	0
ʔac	0	4	0	4	0
ʔac-yu·	0	10	0	10	0
kʷis	1	4	0	5	0.4554859150035953
ʔu-qs	0	4	0	4	0
kuːkuḥʷʼisa	9	1	0	10	0.2959032742893846
ʔat	0	9	0	9	0
quːʔas	64	2	0	66	0.12360498799464747
qawiqaːɬ	3	1	0	4	0.5118595071429148
his-taq	1	14	0	15	0.22294491816723944
ḥuː	4	10	0	14	0.5445684476282008
waː	0	49	0	49	0
ḥuː	4	11	0	15	0.5278615371407821
ʔac-yu·	0	11	0	11	0
ʔuːš-yuːya	0	21	0	21	0
y̓uːqʷaː	0	29	0	29	0
ʔac	0	5	0	5	0
qawiqaːɬ	4	1	0	5	0.4554859150035953
ʔu-qs	0	5	0	5	0
ʔuːš-yuːya	0	22	0	22	0
ʔu-qs	0	6	0	6	0
ʔunaḥ	3	2	0	5	0.6126016192893443
kuːkuḥʷʼisa	10	1	0	11	0.2772917256537885
haʔuk	0	15	0	15	0
ʔumʔi·qsu	12	1	0	13	0.2468472051870251
ʔiːḥ	0	8	1	9	0.3175206571427802
kʷis	1	5	0	6	0.41011848630651815
y̓uːqʷaː	0	30	0	30	0
qʷaː	27	63	0	90	0.5560326498763891
qʷaː	27	64	0	91	0.5534664843326804
ʔaḥʔaː	42	42	1	85	0.6817275117680003
wik	0	100	0	100	0
wik	0	101	0	101	0
čuː	0	48	0	48	0
waː	0	50	0	50	0
qawiqaːɬ	5	1	0	6	0.41011848630651815
ʔumʔi·qsu	13	1	0	14	0.2342215203652865
wik	0	102	0	102	0
hin-aɬa	0	4	0	4	0
hupaɬ	16	0	0	16	0
ʔumʔi·qsu	14	1	0	15	0.22294491816723944
huḥtak	0	20	0	20	0
ɬim̓aqsti	4	0	0	4	0
qawiqaːɬ	6	1	0	7	0.37330396038588737
ʔaya	2	12	6	20	0.8173454221465103
ḥaːw̓iːḥaƛ	8	0	0	8	0
wik	0	103	0	103	0
ʔuːš-yuːya	0	23	0	23	0
ciq	1	10	0	11	0.2772917256537885
kaƛḥ	3	2	0	5	0.6126016192893443
qawiqaːɬ	7	1	0	8	0.34295098019812786
ʔu-ca	0	28	0	28	0
ḥuː	4	12	0	16	0.5118595071429148
hiɬ	12	23	0	35	0.5852041218701719
ʔaḥ	52	9	10	71	0.6972269117216351
qawiqaːɬ	8	1	0	9	0.3175206571427802
qaḥ	2	21	0	23	0.2689203415249328
nay̓iːk	0	15	0	15	0
m̓uč̓ič	0	4	0	4	0
m̓uč̓ič	0	5	0	5	0
qʷaː	27	65	0	92	0.5509102328606122
qʷaː	28	65	0	93	0.5568594401718726
y̓uːqʷaː	0	31	0	31	0
yaːɬ	0	4	0	4	0
ʔaḥ	52	10	10	72	0.7130660541893101
tukuːk	4	0	0	4	0
n̓aːcsa	0	21	0	21	0
kʷis	1	6	0	7	0.37330396038588737
kʷis	1	7	0	8	0.34295098019812786
quːʔas	65	2	0	67	0.12217500704009804
qum̓aː	4	3	0	7	0.6216097450797567
kaƛḥ	4	2	0	6	0.579380164285695
tukuːk	5	0	0	5	0
wik	0	104	0	104	0
ʔunic-ḥn̓a·k	1	3	0	4	0.5118595071429148
ƛaʔuː	8	4	2	14	0.8699155297736261
hicnup	3	2	0	5	0.6126016192893443
ʔaḥ	53	10	10	73	0.7073227869801413
waː	0	51	0	51	0
qʷiq	9	1	0	10	0.2959032742893846
nas	0	5	0	5	0
ʔaƛa	1	6	3	10	0.8173454221465103
y̓uːqʷaː	0	32	0	32	0
t̓aps	0	8	0	8	0
qawiqaːɬ	9	1	0	10	0.2959032742893846
watq	0	4	0	4	0
ʔaƛa	1	7	3	11	0.7827759528141423
qʷiq	10	1	0	11	0.2772917256537885
qum̓aː	5	3	0	8	0.6021808102656679
ḥuː	4	13	0	17	0.4966215830615092
t̓aps	0	9	0	9	0
tukuːk	6	0	0	6	0
ḥuː	4	14	0	18	0.48215936096968104
hiɬ	12	24	0	36	0.579380164285695
ʔu-cpa·	1	4	0	5	0.4554859150035953
hiɬ	13	24	0	37	0.5900891279401312
ʔuːš	7	4	3	14	0.941734626111336
hiɬ	13	25	0	38	0.5847577236324994
ʔaḥʔaː	43	42	1	86	0.6811991014623794
wik	1	104	0	105	0.048972459027300255
kʷis	1	8	0	9	0.3175206571427802
ʔaḥ	53	10	11	74	0.721704654298835
ʔu-y̓i·ḥa	0	7	0	7	0
watq	0	5	0	5	0
ʔaƛakʷaɬ	0	3	1	4	0.5118595071429148
ḥuː	4	15	0	19	0.46845749928108243
qawiqaːɬ	10	1	0	11	0.2772917256537885
hita-ʽsa(ƛ)	0	4	0	4	0
naʔa·	0	13	0	13	0
ciq	1	11	0	12	0.26108936338578836
čuː	0	49	0	49	0
waː	0	52	0	52	0
wik	1	105	0	106	0.04859223843336405
wik	1	106	0	107	0.04821836040964679
wik	1	107	0	108	0.047850662929021535
qʷaː	29	65	0	94	0.5624402840192151
niːw̓a	6	0	0	6	0
nas	0	6	0	6	0
wik-cuk	0	6	0	6	0
waː	0	53	0	53	0
m̓uksy̓i	4	0	0	4	0
ʔu-n̓a·ḥ	0	14	0	14	0
t̓aps	0	10	0	10	0
nay̓iːk	0	16	0	16	0
t̓aps	0	11	0	11	0
tukuːk	7	0	0	7	0
ḥačxʷinƛ	0	4	0	4	0
ʔiːcʔiːqḥ	0	4	0	4	0
čuː	0	50	0	50	0
waː	0	54	0	54	0
ʔu-ca-ḥta	0	6	0	6	0
saya-ʔiː	0	6	0	6	0
ʔu-(w)aƛ	0	4	0	4	0
nism̓a	8	2	0	10	0.4554859150035953
ʔunic	4	5	0	9	0.6252993742043006
huʔa-ca	0	22	0	22	0
čuː	0	51	0	51	0
ʔu-ca	0	29	0	29	0
ḥuː	4	16	0	20	0.4554859150035953
waː	0	55	0	55	0
huḥtak	0	21	0	21	0
naʔaː	0	8	0	8	0
wawaː	3	16	0	19	0.3970120577425188
naʔaː	0	9	0	9	0
wik	1	108	0	109	0.047488989520690576
ʔaʔum	0	5	0	5	0
č̓u	0	4	0	4	0
saya-ʔiː	0	7	0	7	0
ḥuː	4	17	0	21	0.44320704809783756
ʔu-iːy̓ip	0	4	0	4	0
ʔaya	2	13	6	21	0.7998739500319956
qʷaː	29	66	0	95	0.5600319915702128
qʷaː	30	66	0	96	0.5653371812436326
haʔuk	0	16	0	16	0
čuː	0	52	0	52	0
ḥuːɬ	0	10	0	10	0
nuːčyuː	4	2	0	6	0.579380164285695
ʔuːš-yuːya	0	24	0	24	0
waː	0	56	0	56	0
waɬ	0	14	0	14	0
waː	0	57	0	57	0
huḥtak	0	22	0	22	0
quːʔas	66	2	0	68	0.1207809362853011
his-taq	1	15	0	16	0.21280633861277304
waː	0	58	0	58	0
waː	0	59	0	59	0
ʔana	0	7	2	9	0.48215936096968104
čims	4	0	0	4	0
waː	0	60	0	60	0
waː	0	61	0	61	0
waɬ	0	15	0	15	0
qawiqaːɬ	11	1	0	12	0.26108936338578836
qawiqaːɬ	12	1	0	13	0.2468472051870251
čuː	0	53	0	53	0
waɬ	0	16	0	16	0
hiḥ	0	4	0	4	0
waː	0	62	0	62	0
qawiqaːɬ	13	1	0	14	0.2342215203652865
hiɬ-ʼa·ʔa	2	4	0	6	0.579380164285695
ʔaḥku·	3	1	0	4	0.5118595071429148
waː	0	63	0	63	0
ʔac-yu·	0	12	0	12	0
yaːɬ	0	5	0	5	0
ʔumʔi·qsu	15	1	0	16	0.21280633861277304
ḥamip	0	6	0	6	0
kʷis	1	9	0	10	0.2959032742893846
qawiqaːɬ	14	1	0	15	0.22294491816723944
čamiḥta	1	2	1	4	0.9463946303571862
wik	1	109	0	110	0.04713318903179461
ʔiːqḥ	0	10	0	10	0
hiɬ	14	25	0	39	0.5942276457764678
waː	0	64	0	64	0
wik	1	110	0	111	0.0467831154012684
ʔiːqḥ	0	11	0	11	0
ʔaya	2	14	6	22	0.7827759528141423
yaːɬ	0	6	0	6	0
kuːkuḥʷʼisa	11	1	0	12	0.26108936338578836
his	0	4	0	4	0
ƛaʔuː	8	5	2	15	0.8830374409547587
waɬ	0	17	0	17	0
qawiqaːɬ	15	1	0	16	0.21280633861277304
ʔu-kɬa·	0	19	0	19	0
ʔu-kʷiɬ	0	15	0	15	0
hita-ʽsa(ƛ)	0	5	0	5	0
hita-inq-ʽsa(ƛ)	0	6	0	6	0
ʔuḥ	0	25	0	25	0
qawiqaːɬ	16	1	0	17	0.20363696854060853
ʔuḥ	0	26	0	26	0
ʔu-qs	0	7	0	7	0
waː	0	65	0	65	0
ʔu-qs	0	8	0	8	0
ʔaːḥʔasa	0	6	0	6	0
ʔu-qs	0	9	0	9	0
waː	0	66	0	66	0
ʔana-iya	0	16	0	16	0
waː	0	67	0	67	0
ʔumʔi·qsu	16	1	0	17	0.20363696854060853
kuːkuḥʷʼisa	12	1	0	13	0.2468472051870251
tuškuːḥ	3	1	0	4	0.5118595071429148
ʕac̓ik	0	4	0	4	0
qawiqaːɬ	17	1	0	18	0.1953001594734786
kuːkuḥʷʼisa	13	1	0	14	0.2342215203652865
qawiqaːɬ	18	1	0	19	0.1876840927049947
n̓uw̓i·qsu	2	3	0	5	0.6126016192893443
waː	0	68	0	68	0
n̓uw̓i·qsu	3	3	0	6	0.6309297535714575
qʷaː	30	67	0	97	0.5630030241460999
ʔaḥʔaː	44	42	1	87	0.6805611621174296
muː-qʔičḥ	2	3	0	5	0.6126016192893443
n̓uw̓i·qsu	4	3	0	7	0.6216097450797567
čuː	0	54	0	54	0
ʔiːqḥ	0	12	0	12	0
qʷis	9	39	0	48	0.4392610297141858
ʔac-yu·	0	13	0	13	0
waː	0	69	0	69	0
ʔac-yu·	0	14	0	14	0
qawiqaːɬ	19	1	0	20	0.1806963615767855
qawiqaːɬ	20	1	0	21	0.17425991310347752
tukuːk	8	0	0	8	0
ʔu-ḥta·	0	6	0	6	0
ʔiːḥ	1	8	1	10	0.5816718657178869
c̓ax	1	3	0	4	0.5118595071429148
wik	1	111	0	112	0.04643862744521372
wik	1	112	0	113	0.04609958865310732
k̓ʷač	0	5	0	5	0
t̓aps	0	12	0	12	0
ḥuː	4	18	0	22	0.43158020163114585
hin-i·ʔatu	0	4	0	4	0
ḥaːɬ	1	11	2	14	0.5970948432879917
qʷis	9	40	0	49	0.43410971756178374
nuːčyuː	5	2	0	7	0.5445684476282008
čuː	0	55	0	55	0
waː	0	70	0	70	0
waː	0	71	0	71	0
wik	1	113	0	114	0.04576586699420693
wik	1	114	0	115	0.045437334733564
čuː	0	56	0	56	0
waː	0	72	0	72	0
m̓uč̓ič	0	6	0	6	0
qawiqaːɬ	21	1	0	22	0.1683099680160561
čuː	0	57	0	57	0
waː	0	73	0	73	0
n̓uw̓i·qsu	5	3	0	8	0.6021808102656679
qʷis	9	41	0	50	0.4290808428709485
qʷis	9	42	0	51	0.42417080326490036
t̓aps-ʼatu	0	4	0	4	0
qawiqaːɬ	22	1	0	23	0.16279165503752757
tukuːk	9	0	0	9	0
quːʔas	67	2	0	69	0.119421393992022
qawiqaːɬ	23	1	0	24	0.15765817343911248
n̓uw̓i·qsu	5	4	0	9	0.6252993742043006
waː	0	74	0	74	0
waː	0	75	0	75	0
ʔu-kɬa·	0	20	0	20	0
waː	0	76	0	76	0
huḥtak	0	23	0	23	0
qawiqaːɬ	24	1	0	25	0.15286935115005695
hita-ʽsa(ƛ)	0	6	0	6	0
n̓uw̓i·qsu	6	4	0	10	0.6126016192893443
kuːkuḥʷʼisa	14	1	0	15	0.22294491816723944
ʔu-ʼiːḥ	0	11	0	11	0
ʔu-ca	0	30	0	30	0
waɬ	0	18	0	18	0
waː	0	77	0	77	0
waː	0	78	0	78	0
haʔuk	0	17	0	17	0
čuː	0	58	0	58	0
qʷis	9	43	0	52	0.41937604520416494
qawiqaːɬ	25	1	0	26	0.14839050243285176
waː	0	79	0	79	0
qʷis	10	43	0	53	0.4408308413217515
qʷis	11	43	0	54	0.4601206284143141
qaḥ	2	22	0	24	0.26108936338578836
waː	0	80	0	80	0
wik	1	115	0	116	0.04511386825708782
kaːpap	0	4	0	4	0
ḥaːḥuːp	0	8	0	8	0
wik	1	116	0	117	0.04479534790514317
ʔaḥ	54	10	11	75	0.7161006259580136
ciq-y̓akʷ	6	1	0	7	0.37330396038588737
qiː	1	19	0	20	0.1806963615767855
ʔiːqḥ	0	13	0	13	0
qawiqaːɬ	26	1	0	27	0.1441915148462777
hiɬ	15	25	0	40	0.6021808102656679
qʷi-ʔiː	4	0	0	4	0
quːʔas	68	2	0	70	0.11809506962344107
waː	0	81	0	81	0
saya-ʔiː	0	8	0	8	0
y̓uːqʷaː	0	33	0	33	0
maːʔak	11	0	0	11	0
wawaː	3	17	0	20	0.3847663931726611
yaqʷ	10	0	0	10	0
n̓uw̓i·qsu	7	4	0	11	0.5966452229439912
ḥuːɬ	0	11	0	11	0
ʔu-cpa·	2	4	0	6	0.579380164285695
yaqʷ-(č)iɬ	11	3	0	14	0.472941950941057
mamaɬn̓i	10	1	0	11	0.2772917256537885
wa·	5	170	0	175	0.11809506962344107
ʔaḥʔaː	45	42	1	88	0.6798215135961505
qawiqaːɬ	27	1	0	28	0.14024611344719426
hiɬ	15	26	0	41	0.5977650169975307
tukuːk	10	0	0	10	0
ʔaya	2	15	6	23	0.7661350110985075
tukuːk	11	0	0	11	0
ʔuːš	7	5	3	15	0.9500685975366213
ʔuːš	7	6	3	16	0.949701216438411
ʔaḥʔaː	45	43	1	89	0.6796850386288313
maːʔak	12	0	0	12	0
č̓u	0	5	0	5	0
k̓ʷak̓ʷaƛ	5	0	0	5	0
k̓ʷak̓ʷaƛ	6	0	0	6	0
hiɬ	15	27	0	42	0.593254388190763
ʔuːš	8	6	3	17	0.9360847109776411
ʔuːš	9	6	3	18	0.920619835714305
ʔana-iya	0	17	0	17	0
ʔu-n̓a·ḥ	0	15	0	15	0
y̓uːqʷaː	0	34	0	34	0
ʔu-n̓a·ḥ	0	16	0	16	0
hiɬ	16	27	0	43	0.6008127163913244
qʷaː	30	68	0	98	0.5606736244508915
qʷaː	30	69	0	99	0.5583498890229236
qʷaː	31	69	0	100	0.5635297099909077
tukuːk	12	0	0	12	0
qʷaː	32	69	0	101	0.5684063156308035
naʔaː	0	10	0	10	0
naʔaː	0	11	0	11	0
ciq	1	12	0	13	0.2468472051870251
naʔaː	0	12	0	12	0
ʔaḥʔaː	46	43	1	90	0.6789753644349432
qʷis	11	44	0	55	0.4554859150035953
qawiqaːɬ	28	1	0	29	0.13653126326509574
qawiqaːɬ	29	1	0	30	0.1330266805824107
qawiqaːɬ	29	2	0	31	0.21774478247146226
čuː	0	59	0	59	0
ʔaḥʔaː	47	43	1	91	0.6781749644996233
čuː	0	60	0	60	0
ʔu-qḥɬi	0	7	0	7	0
qʷisḥ	3	2	0	5	0.6126016192893443
naʔa·	0	14	0	14	0
wik	1	117	0	118	0.04448165781419844
wik	1	118	0	119	0.04417268576607079
ʔu-n̓a·ḥ	0	17	0	17	0
haʔum	6	1	0	7	0.37330396038588737
ʔu-ca	0	31	0	31	0
čuː	0	61	0	61	0
ʔu-ca-ḥta	0	7	0	7	0
hiɬ-ʼatḥ	17	3	0	20	0.3847663931726611
suːḥaː	4	0	0	4	0
yac-panač	0	4	0	4	0
wa·ɬ-ʼaqstuƛ	0	4	0	4	0
siːḥ-iɬ	0	4	0	4	0
čukʷaː	0	4	0	4	0
wa·	5	171	0	176	0.1175735601190598
mač	0	9	0	9	0
mač	0	10	0	10	0
čaʔaːɬ-či·	0	5	0	5	0
wa·	5	172	0	177	0.1170570889981265
hin-iːʔas	0	4	0	4	0
ʔu-ca	0	32	0	32	0
c̓aʔak	9	2	0	11	0.43158020163114585
mač	0	11	0	11	0
nay̓iːk	0	17	0	17	0
ʔu-taq	0	5	0	5	0
ɬuːcma	17	5	0	22	0.4878517150631748
kuːčiɬ	0	4	0	4	0
n̓aːcsa	0	22	0	22	0
qʷaː	33	69	0	102	0.5729967408607366
piḥ	0	8	0	8	0
wa·	5	173	0	178	0.1165455810556187
naʔa·	0	15	0	15	0
wa·	6	173	0	179	0.1335969634922137
sukʷi(ƛ)-ʼas	0	4	0	4	0
sukʷi(ƛ)	0	15	0	15	0
n̓aːcsa	0	23	0	23	0
qʷaː	34	69	0	103	0.5773168357665118
ƛawa-ʔiː	0	5	0	5	0
ʔinkʷ-ʽiɬ	4	0	0	4	0
ḥaː	7	12	0	19	0.5990375260966421
ʔinkʷ	13	3	0	16	0.4392610297141858
ḥaː	7	13	0	20	0.5893313279970291
n̓aːcsa	0	24	0	24	0
qʷis	12	44	0	56	0.472941950941057
his-taq	1	16	0	17	0.20363696854060853
kukʷinksi	3	1	0	4	0.5118595071429148
ʔaḥ	54	11	11	76	0.7303100750336359
ʕam̓iːt	4	0	0	4	0
haʔuk	0	18	0	18	0
qʷaː	34	70	0	104	0.5752513123937681
qʷaː	35	70	0	105	0.579380164285695
haʔuk	0	19	0	19	0
haʔuk	0	20	0	20	0
ʔu-ʼi·c	0	8	0	8	0
suːḥaː	5	0	0	5	0
ƛaqmis	4	0	0	4	0
ƛumk	0	7	0	7	0
sut-(č)iɬ	0	11	0	11	0
wa·	6	174	0	180	0.1330266805824107
huḥtak	0	24	0	24	0
qʷaː	36	70	0	106	0.5832675161562912
quʔušin-m̓i·t	4	0	0	4	0
kuw̓iɬa	0	6	0	6	0
ʔu-ca	0	33	0	33	0
quʔušin-m̓i·t	5	0	0	5	0
n̓aːcsa	0	25	0	25	0
quːʔas	69	2	0	71	0.11680071927021261
huḥtak	0	25	0	25	0
čukʷaː	0	5	0	5	0
mač	0	12	0	12	0
waː	0	82	0	82	0
mač	0	13	0	13	0
čuː	0	62	0	62	0
ʔu-n̓a·ḥ	0	18	0	18	0
wiːy̓a	0	15	0	15	0
sukʷi(ƛ)	0	16	0	16	0
ʕam̓iːt	5	0	0	5	0
wa·	6	175	0	181	0.13246173572622066
wik	1	119	0	120	0.04386832304434453
y̓uːqʷaː	0	35	0	35	0
naʔa·	0	16	0	16	0
ʕam̓iːt	6	0	0	6	0
čakup	16	0	0	16	0
ƛawa	0	7	0	7	0
ʔinkʷ	14	3	0	17	0.42417080326490036
ʕam̓iːt	7	0	0	7	0
wa·	6	176	0	182	0.13190205167213898
ḥaː	7	14	0	21	0.579380164285695
ʔinkʷ	15	3	0	18	0.41011848630651815
n̓aːcsa	0	26	0	26	0
ʔinkʷ	16	3	0	19	0.3970120577425188
wik̓iːt	0	22	0	22	0
ƛaqmis	5	0	0	5	0
kukʷinksi	4	1	0	5	0.4554859150035953
ʔaḥʔaː	48	43	1	92	0.6772901664831855
qʷisḥ	3	3	0	6	0.6309297535714575
kumt-kʷa	0	4	0	4	0
kukʷinksi	5	1	0	6	0.41011848630651815
yac-panač	0	5	0	5	0
quʔušin-m̓i·t	6	0	0	6	0
qʷaː	36	71	0	107	0.5813258323253162
haʔuk	0	21	0	21	0
haʔuk	0	22	0	22	0
ʔu-ca-ḥta	0	8	0	8	0
hiɬ-ʼatḥ	18	3	0	21	0.37330396038588737
c̓aʔak	10	2	0	12	0.41011848630651815
wa·	6	177	0	183	0.13134755267865894
n̓aːcsiː	0	13	0	13	0
ʔu-kʷiɬ	0	16	0	16	0
wa·	6	178	0	184	0.13079816447717588
yac-panač	0	6	0	6	0
n̓aːcsa	0	27	0	27	0
mač	0	14	0	14	0
mač	0	15	0	15	0
t̓iqʷ-ʽiɬ	0	4	0	4	0
haʔuk	0	23	0	23	0
wa·	6	179	0	185	0.13025381423598775
quʔušin-m̓i·t	7	0	0	7	0
quʔušin-m̓i·t	8	0	0	8	0
hin-iːʔas	0	5	0	5	0
ʔu-ca-ḥta	0	9	0	9	0
c̓aʔak	11	2	0	13	0.3907866554552209
n̓aːcsa	0	28	0	28	0
quʔušin-m̓i·t	9	0	0	9	0
kaːʔa	0	4	0	4	0
wa·	6	180	0	186	0.1297144305253523
waːsniːp-m̓i·t	4	0	0	4	0
sukʷiƛ	0	7	0	7	0
sukʷi(ƛ)	0	17	0	17	0
m̓uksy̓i	5	0	0	5	0
his	0	5	0	5	0
quʔušin-m̓i·t	10	0	0	10	0
haʔuk	0	24	0	24	0
haʔuk	0	25	0	25	0
ƛaʔuː	9	5	2	16	0.8620485698650453
ƛaʔuː	10	5	2	17	0.8409160494198368
wawaː	3	18	0	21	0.37330396038588737
waʔič	0	6	0	6	0
qiː	1	20	0	21	0.17425991310347752
waʔič	0	7	0	7	0
ƛumk	0	8	0	8	0
wa·	6	181	0	187	0.1291799432835659
wa·	6	182	0	188	0.1286502837840284
ʔu-kʷiɬ	0	17	0	17	0
waːsniːp-m̓i·t	5	0	0	5	0
ʔuyi	0	25	0	25	0
n̓aːs	6	0	0	6	0
wa·	6	183	0	189	0.12812538460326173
ʔam̓iː	0	4	0	4	0
w̓aqʔuː	0	4	0	4	0
waːsniːp-m̓i·t	6	0	0	6	0
hin-in	0	9	0	9	0
mač	0	16	0	16	0
mač	0	17	0	17	0
t̓iqʷ-ʽiɬ	0	5	0	5	0
wa·	6	184	0	190	0.12760517958984874
waːsniːp-m̓i·t	7	0	0	7	0
ʔaya	2	16	6	24	0.7500000000000001
huḥtak	0	26	0	26	0
wiːy̓a	0	16	0	16	0
wik	1	120	0	121	0.04356846429756592
wič-siɬa	0	5	0	5	0
ʔu-ca-ḥta	0	10	0	10	0
c̓aʔak	12	2	0	14	0.37330396038588737
y̓uːqʷaː	0	36	0	36	0
ḥačw̓aḥs	4	0	0	4	0
ɬuːcma	18	5	0	23	0.47658882290132026
čakup	17	0	0	17	0
ḥačw̓aḥs	5	0	0	5	0
quʔušin-m̓i·t	11	0	0	11	0
sukʷiƛ	0	8	0	8	0
m̓uksy̓i	6	0	0	6	0
his	0	6	0	6	0
his	0	7	0	7	0
wik̓iːt	0	23	0	23	0
waːɬak	0	4	0	4	0
wik-ʕaƛ	0	4	0	4	0
wawaː	3	19	0	22	0.3625547592300896
ʕišiː	4	0	0	4	0
wiːy̓a	0	17	0	17	0
quʔušin-m̓i·t	12	0	0	12	0
wa·-na·k	0	4	0	4	0
ʔunw̓iːƛ	0	12	0	12	0
ʕišiː	5	0	0	5	0
quʔušin-m̓i·t	13	0	0	13	0
wik	1	121	0	122	0.043273007408842545
wič-siɬa	0	6	0	6	0
qiː	1	21	0	22	0.1683099680160561
huːʔak	0	23	1	24	0.15765817343911248
ʔuyi	0	26	0	26	0
qiː-sasa	0	4	0	4	0
ʔaḥ	54	12	11	77	0.7432298474982981
mamaɬn̓i	11	1	0	12	0.26108936338578836
qiː	1	22	0	23	0.16279165503752757
ciq	1	13	0	14	0.2342215203652865
quːʔas	70	2	0	72	0.11553716142688074
ʔiːqḥ	0	14	0	14	0
waː	0	83	0	83	0
waː	0	84	0	84	0
ʔaya	2	17	6	25	0.7343962125424432
huːʔak	0	24	1	25	0.15286935115005695
hiːɬ	0	5	0	5	0
ḥaːɬ	1	12	2	15	0.5713619478607344
qʷayac̓iːk	27	0	0	27	0
qʷaː	37	71	0	108	0.5850473163723333
huːʔak	0	25	1	26	0.14839050243285176
qʷaː	38	71	0	109	0.5885521145226215
y̓uːqʷaː	0	37	0	37	0
qʷaː	39	71	0	110	0.5918513209463806
ʔaqi-ʔišt	13	0	0	13	0
qʷayac̓iːk	28	0	0	28	0
ḥaw̓iɬ	23	6	0	29	0.46405424810945645
su	0	4	0	4	0
hin-iːʔas	0	6	0	6	0
qʷayac̓iːk	29	0	0	29	0
naʔaː	0	13	0	13	0
ʔaḥ	54	13	11	78	0.7549962964918077
qʷayac̓iːk	30	0	0	30	0
čuː	0	63	0	63	0
kaƛḥ	4	3	0	7	0.6216097450797567
ʔiːqḥ	0	15	0	15	0
ḥaw̓iɬ	24	6	0	30	0.4554859150035953
ḥaːw̓iɬaƛ	4	2	0	6	0.579380164285695
kaƛḥ	4	4	0	8	0.6309297535714575
nism̓a	8	3	0	11	0.5333570581245947
hiɬ	16	28	0	44	0.5966452229439912
ʔaḥ	55	13	11	79	0.7496438246089732
ƛaʔuː	10	6	2	18	0.8527924884900406
n̓aːcsa	0	29	0	29	0
qʷayac̓iːk	31	0	0	31	0
tup̓aɬ	4	0	0	4	0
ʔaya	2	18	6	26	0.7193329040881774
qʷaːƛaː	0	7	0	7	0
su	0	5	0	5	0
qʷayac̓iːk	32	0	0	32	0
ʔaya	2	19	6	27	0.7048084683610077
ʔaḥ	56	13	11	80	0.7443623096128031
maːsuːɬ	0	5	0	5	0
qʷayac̓iːk	33	0	0	33	0
maːsuːɬ	0	6	0	6	0
y̓uːqʷaː	0	38	0	38	0
ʔuyaː-siɬa	0	6	0	6	0
ḥaw̓iɬ	25	6	0	31	0.44722551669814065
huḥtak	0	27	0	27	0
kʷis-siɬa	0	4	0	4	0
ʔaḥ	57	13	11	81	0.7391509943793184
yaqʷ	11	0	0	11	0
maːsuːɬ	0	7	0	7	0
qʷayac̓iːk	34	0	0	34	0
ʔaya	2	20	6	28	0.690814021097605
čuː	0	64	0	64	0
ciq	1	14	0	15	0.22294491816723944
huːʔak	0	26	1	27	0.1441915148462777
ʔuyi	0	27	0	27	0
qʷayac̓iːk	35	0	0	35	0
ʔu-kʷiɬ	0	18	0	18	0
quːʔas	71	2	0	73	0.11430327308760628
qʷaː	39	72	0	111	0.5900891279401312
quːʔas	72	2	0	74	0.11309798613327456
qʷaː	40	72	0	112	0.593254388190763
naʔaː	0	14	0	14	0
qʷaː	40	73	0	113	0.5915435793355442
y̓uːqʷaː	0	39	0	39	0
maːmaːti	5	1	0	6	0.41011848630651815
ʔu-ca-ḥta	0	11	0	11	0
ḥuːɬ	1	11	0	12	0.26108936338578836
ʔaḥʔaː	48	44	1	93	0.6773918153177659
ḥaːw̓iɬaƛ	5	2	0	7	0.5445684476282008
qʷayac̓iːk	36	0	0	36	0
his-taq	1	17	0	18	0.1953001594734786
ƛaʔuː	11	6	2	19	0.8350554511591555
ḥaːw̓iɬaƛ	6	2	0	8	0.5118595071429148
qaɬaːtik	4	0	0	4	0
waː	0	85	0	85	0
waː	0	86	0	86	0
čuː	0	65	0	65	0
yaːc	0	14	0	14	0
qʷayac̓iːk	37	0	0	37	0
hawiɬ-čaq	0	14	0	14	0
ƛuːkʷaːna	2	2	0	4	0.6309297535714575
ʔiːqḥ	0	16	0	16	0
qʷayac̓iːk	38	0	0	38	0
sa-štu·p	5	0	0	5	0
čamiḥta	2	2	1	5	0.9602297178607614
hapt	1	10	0	11	0.2772917256537885
qʷayac̓iːk	39	0	0	39	0
hayim	0	6	0	6	0
yaqʷ	12	0	0	12	0
quːʔas	73	2	0	75	0.11192028398481693
ƛuːkʷaːna	3	2	0	5	0.6126016192893443
ʔu-ca	0	34	0	34	0
naʔaː	0	15	0	15	0
c̓iːq	1	7	0	8	0.34295098019812786
ḥaːw̓iɬaƛ	7	2	0	9	0.48215936096968104
naʔaː	0	16	0	16	0
ʔu-ca	0	35	0	35	0
ḥuːɬ	1	12	0	13	0.2468472051870251
yaqʷ-(č)iɬ	12	3	0	15	0.4554859150035953
waː	0	87	0	87	0
hiɬ	17	28	0	45	0.6034574347115926
ʔu-ca	0	36	0	36	0
his-i·k	3	3	0	6	0.6309297535714575
huḥtak	0	28	0	28	0
huʔa-ca	0	23	0	23	0
ƛaḥ	1	9	0	10	0.2959032742893846
his-taq	1	18	0	19	0.1876840927049947
naʔaː	0	17	0	17	0
qiː	1	23	0	24	0.15765817343911248
qʷayac̓iːk	40	0	0	40	0
muː-či·ɬ	2	3	0	5	0.6126016192893443
hiːtkin	1	2	1	4	0.9463946303571862
n̓aːs	7	0	0	7	0
ʔaːḥʔasa	0	7	0	7	0
hiš	2	2	2	6	1
ʔuːš	9	7	3	19	0.922317214818483
qʷayac̓iːk	41	0	0	41	0
ʔu-ca	0	37	0	37	0
qaːy̓uːk̓ʷatḥ	5	0	0	5	0
ʔu-ca	0	38	0	38	0
c̓iːq	1	8	0	9	0.3175206571427802
ʔatḥ	0	4	0	4	0
ʕac̓ik	0	5	0	5	0
ḥaːw̓iɬaƛ	8	2	0	10	0.4554859150035953
qʷi-ʼi·c	4	0	0	4	0
qʷayac̓iːk	42	0	0	42	0
muwač	5	0	0	5	0
ʔuḥ	0	27	0	27	0
haʔum	7	1	0	8	0.34295098019812786
muwač	6	0	0	6	0
haʔukʷ	0	4	0	4	0
ʔu-ʼi·c	0	9	0	9	0
yaqʷ-(č)iɬ	12	4	0	16	0.5118595071429148
mamaɬn̓i	12	1	0	13	0.2468472051870251
waː	0	88	0	88	0
ʔu-ʼi·c	0	10	0	10	0
haʔuk	0	26	0	26	0
wik	1	122	0	123	0.04298185337149844
ʔaḥ	58	13	11	82	0.7340090755939154
qʷayac̓iːk	43	0	0	43	0
ḥuːɬ	2	12	0	14	0.37330396038588737
wik	1	123	0	124	0.04269490617045788
kamatq	0	23	0	23	0
qʷaː	41	73	0	114	0.5945828680064026
ƛ̓ay̓ix	0	4	0	4	0
ḥaːw̓iɬaƛ	9	2	0	11	0.43158020163114585
hin-as	0	4	0	4	0
ḥaːɬ	2	12	2	16	0.6695919455357793
qʷaː	41	74	0	115	0.5929213086637791
y̓uːqʷaː	0	40	0	40	0
ʔaƛakʷaɬ	1	3	1	5	0.8649735207179273
hiɬ	17	29	0	46	0.5995963119244929
ʔaḥ	59	13	11	83	0.7289357114315103
nuč-a·n̓uɬ	4	0	0	4	0
huʔa-ca	0	24	0	24	0
ʔu-ca	0	39	0	39	0
hiɬ-ʼatḥ	19	3	0	22	0.3625547592300896
ʔu-ca	0	40	0	40	0
waː	0	89	0	89	0
maːtmaːs	5	0	0	5	0
ʔu-ca	0	41	0	41	0
ʔana-iya	0	18	0	18	0
his-i·k	3	4	0	7	0.6216097450797567
nuːčyuː	6	2	0	8	0.5118595071429148
his-i·k	3	5	0	8	0.6021808102656679
qʷayac̓iːk	44	0	0	44	0
n̓aːcsa	0	30	0	30	0
ḥuː	4	19	0	23	0.420564119145802
ʔaḥʔaː	48	45	1	94	0.677375329823252
hin-aɬa	0	5	0	5	0
waː	0	90	0	90	0
hupaɬ	17	0	0	17	0
wik	1	124	0	125	0.04241207266905125
wiːnap	0	4	0	4	0
saya·	0	4	0	4	0
qiː	1	24	0	25	0.15286935115005695
hin-as	0	5	0	5	0
hupaɬ	18	0	0	18	0
hupaɬ	19	0	0	19	0
čuː	0	66	0	66	0
wiːnap	0	5	0	5	0
hiɬ	18	29	0	47	0.6057674312202589
ʔiːḥ	1	8	2	11	0.6913698302025115
wiːnap	0	6	0	6	0
ʔu-(y)i·	0	5	0	5	0
ḥaːw̓iɬaƛ	10	2	0	12	0.41011848630651815
ʔu-ʼi·c	0	11	0	11	0
muwač	7	0	0	7	0
muwač	8	0	0	8	0
ʔu-ʼi·c	0	12	0	12	0
naq	0	11	0	11	0
ʔutwiː	0	4	0	4	0
haʔuk	0	27	0	27	0
ʔaḥʔaː	48	46	1	95	0.6772481848146252
qʷayac̓iːk	45	0	0	45	0
haʔuk	0	28	0	28	0
qʷayac̓iːk	46	0	0	46	0
ʕaʔuk	3	1	0	4	0.5118595071429148
ʔu-na·k	0	27	0	27	0
qʷayac̓iːk	47	0	0	47	0
ƛ̓ay̓ix	0	5	0	5	0
ƛ̓ay̓ix	0	6	0	6	0
muwač	9	0	0	9	0
qaḥ	2	23	0	25	0.25374681736588833
waʔič	0	8	0	8	0
wik	1	125	0	126	0.04213326250095358
qaḥ	2	24	0	26	0.2468472051870251
waː	0	91	0	91	0
wiːy̓a	0	18	0	18	0
qaḥ	2	25	0	27	0.24035053544298987
waː	0	92	0	92	0
sa-štu·p	6	0	0	6	0
qaḥ	2	26	0	28	0.2342215203652865
qʷaː	41	75	0	116	0.591250589300929
y̓uːqʷaː	0	41	0	41	0
ʕaḥmis	4	0	0	4	0
wiːy̓a	0	19	0	19	0
qaḥ	2	27	0	29	0.22842890703676905
waː	0	93	0	93	0
wawaː	3	20	0	23	0.35245589292997376
qʷayac̓iːk	48	0	0	48	0
c̓iːq	1	9	0	10	0.2959032742893846
ʔaḥʔaː	49	46	1	96	0.6766180566977155
qʷayac̓iːk	49	0	0	49	0
wik	1	126	0	127	0.04185838796698677
qʷaː	41	76	0	117	0.5895717634693378
qʷaː	42	76	0	118	0.5926037494917388
čamiḥta	2	3	1	6	0.920619835714305
niːw̓a	7	0	0	7	0
ciq	1	15	0	16	0.21280633861277304
waː	0	94	0	94	0
wa·	6	185	0	191	0.1270896038342622
niːw̓a	8	0	0	8	0
ʔaḥʔaː	49	47	1	97	0.6764938567155929
qʷayac̓iːk	50	0	0	50	0
ʔaːḥʔasa	0	8	0	8	0
čuː	0	67	0	67	0
yaːc	0	15	0	15	0
yaːc	0	16	0	16	0
hiɬ	19	29	0	48	0.6110308656006143
qiː	1	25	0	26	0.14839050243285176
naʔaː	0	18	0	18	0
ḥaw̓iɬ	26	6	0	32	0.4392610297141858
hiš	3	2	2	7	0.9821410328348753
naʔaː	0	19	0	19	0
tuːḥuk	0	4	0	4	0
hiːtkin	1	3	1	5	0.8649735207179273
qʷayac̓iːk	51	0	0	51	0
maːsuːɬ	0	8	0	8	0
ʔaḥ	60	13	11	84	0.7239300283295473
ʔaḥ	61	13	11	85	0.7189911269598694
muː-p̓it-ʕaƛ	0	4	0	4	0
muː-p̓it-ʕaƛ	0	5	0	5	0
hiːtkin	1	4	1	6	0.7896900821428475
wa·	6	186	0	192	0.12657859363955407
ḥaːw̓iɬaƛ	11	2	0	13	0.3907866554552209
kʷis-siɬa	0	5	0	5	0
ḥaːw̓iɬaƛ	12	2	0	14	0.37330396038588737
wik-stup	0	4	0	4	0
ʔaːḥʔasa	0	9	0	9	0
suč̓as	7	0	1	8	0.34295098019812786
his-i·k	4	5	0	9	0.6252993742043006
qʷaː	42	77	0	119	0.5909713204264327
y̓uːqʷaː	0	42	0	42	0
ḥaːɬ	3	12	2	17	0.7315975941709253
suč̓as	8	0	1	9	0.3175206571427802
qʷaː	42	78	0	120	0.5893313279970291
ʔaḥʔaː	50	47	1	98	0.6758872274737592
qʷis	12	45	0	57	0.46845749928108243
ʔaḥʔaː	51	47	1	99	0.6752027757740526
suč̓as	9	0	1	10	0.2959032742893846
ʔaḥ	62	13	11	86	0.7141180874924266
n̓aːcsa	0	31	0	31	0
ʔaḥku·	3	2	0	5	0.6126016192893443
hiɬ	20	29	0	49	0.6154883479468025
kʷis-siɬa	0	6	0	6	0
ƛaḥ	1	10	0	11	0.2772917256537885
ḥuː	4	20	0	24	0.41011848630651815
naʔaː	0	20	0	20	0
naʔaː	0	21	0	21	0
ʔaya	2	21	6	29	0.6773358982844032
huḥtak	0	29	0	29	0
ʔaya	2	22	6	30	0.664357405712226
huḥtak	0	30	0	30	0
quːʔas	74	2	0	76	0.11076919850004079
ʔaḥ	62	13	12	87	0.7270243186597827
waː	0	95	0	95	0
ƛaḥ	1	11	0	12	0.26108936338578836
yaqʷ-(č)iɬ	13	4	0	17	0.4966215830615092
mamaɬn̓i	13	1	0	14	0.2342215203652865
waː	0	96	0	96	0
huːʔak	0	27	1	28	0.14024611344719426
ʔuyi	0	28	0	28	0
qiː	1	26	0	27	0.1441915148462777
qiː-sasa	0	5	0	5	0
n̓aːcsiː	0	14	0	14	0
ʔuːš	9	8	3	20	0.9197173235750932
hiɬ	20	30	0	50	0.6126016192893443
ʔaḥ	63	13	12	88	0.7222430762217958
ʔiːḥ	1	9	2	12	0.6567045482143387
k̓ʷač	0	6	0	6	0
hiniːp	0	4	0	4	0
čuː	0	68	0	68	0
waː	0	97	0	97	0
quːʔas	75	2	0	77	0.1096438070934566
huːʔak	0	28	1	29	0.13653126326509574
qʷaːƛaː	0	8	0	8	0
hin-as	0	6	0	6	0
ʔaḥ	64	13	12	89	0.7175231538581125
qʷaː	42	79	0	121	0.5876846855359188
qʷayac̓iːk	52	0	0	52	0
qʷaːƛaː	0	9	0	9	0
yaqʷ	13	0	0	13	0
c̓aʔak	13	2	0	15	0.35742770336531254
hiʔiːs	1	8	0	9	0.3175206571427802
qʷayac̓iːk	53	0	0	53	0
wik	1	127	0	128	0.04158736393652892
ʔaḥ	65	13	12	90	0.7128637248309617
huḥtak	0	31	0	31	0
ʔu-ktis	0	7	0	7	0
hupaɬ	20	0	0	20	0
hin-aɬa	0	6	0	6	0
hupaɬ	21	0	0	21	0
yaqʷ-(č)iɬ	14	4	0	18	0.48215936096968104
mamaɬn̓i	14	1	0	15	0.22294491816723944
waː	0	98	0	98	0
huʔa-in	0	4	0	4	0
c̓iːq	1	10	0	11	0.2772917256537885
ʔu-ḥʷʼaɬ	0	17	0	17	0
muː-či·ɬ	2	4	0	6	0.579380164285695
kaƛḥ	4	5	0	9	0.6252993742043006
wik̓iːt	0	24	0	24	0
ʔink	4	0	0	4	0
wik̓iːt	0	25	0	25	0
ʔink	5	0	0	5	0
ʔana	0	8	2	10	0.4554859150035953
ḥaːɬ	3	13	2	18	0.707974905777612
ʔink	6	0	0	6	0
ḥaːɬ	3	14	2	19	0.6858128831725212
ʔana	0	9	2	11	0.43158020163114585
waː	0	99	0	99	0
ḥamip	0	7	0	7	0
quːʔas	76	2	0	78	0.10854323006054539
ḥaːɬ	4	14	2	20	0.7298466991620975
maʔas	5	0	0	5	0
ʔiːḥ	1	9	3	13	0.7193329040881774
ʔuna-ḥ	3	1	0	4	0.5118595071429148
maḥt̓iː	8	2	0	10	0.4554859150035953
maḥt̓iː	8	3	0	11	0.5333570581245947
ʔaḥku·	3	3	0	6	0.6309297535714575
hiɬ	20	31	0	51	0.6095900382177758
ʔaḥ	66	13	12	91	0.7082639507760767
hiːɬ	0	6	0	6	0
ʔaḥ	66	14	12	92	0.719501106797484
c̓awaːk	3	8	2	13	0.8420887815606471
ʔaḥ	66	15	12	93	0.7299032875504213
ʔaƛakʷaɬ	2	3	1	6	0.920619835714305
qʷayac̓iːk	54	0	0	54	0
maḥt̓iː	9	3	0	12	0.5118595071429148
qʷaː	42	80	0	122	0.5860322536121206
muː-p̓it	1	3	0	4	0.5118595071429148
čuː	0	69	0	69	0
kaƛḥ	4	6	0	10	0.6126016192893443
muː-či·ɬ	2	5	0	7	0.5445684476282008
muː-či·ɬ	3	5	0	8	0.6021808102656679
qʷayac̓iːk	55	0	0	55	0
yaqʷ	14	0	0	14	0
yaqʷ	15	0	0	15	0
ʔap-quː-ʼa·	1	3	0	4	0.5118595071429148
hiɬ	20	32	0	52	0.6064727741416686
nay̓iːk	0	18	0	18	0
qʷayac̓iːk	56	0	0	56	0
ʔaːḥʔasa	0	10	0	10	0
wik	1	128	0	129	0.04132010775329306
wik	1	129	0	130	0.041056539145249066
č̓apac	36	1	0	37	0.11309798613327456
qʷayac̓iːk	57	0	0	57	0
his	0	8	0	8	0
hiniːp	0	5	0	5	0
huʔa-aːs	0	7	0	7	0
ƛuːkʷaːna	4	2	0	6	0.579380164285695
hayim	0	7	0	7	0
qʷayac̓iːk	58	0	0	58	0
maːsuːɬ	0	9	0	9	0
muː-p̓it-ʕaƛ	0	6	0	6	0
ʔaḥʔaː	52	47	1	100	0.6744454683101252
hiniːp	0	6	0	6	0
ḥaːw̓iɬaƛ	13	2	0	15	0.35742770336531254
čuː	0	70	0	70	0
waː	0	100	0	100	0
wik	1	130	0	131	0.04079658013847723
ʔiːqḥ	0	17	0	17	0
wik	1	131	0	132	0.04054015497475322
ʔiːqḥ	0	18	0	18	0
qʷis	13	45	0	58	0.4843342266225852
n̓up-qʔičḥ	2	2	0	4	0.6309297535714575
n̓up-či·ɬ	2	3	0	5	0.6126016192893443
hapt	1	11	0	12	0.26108936338578836
ḥaːw̓iɬaƛ	14	2	0	16	0.34295098019812786
wik	1	132	0	133	0.04028719003267743
ḥaːw̓iɬaƛ	15	2	0	17	0.32969825740304703
qʷaː	42	81	0	123	0.5843748431355574
qʷaː	43	81	0	124	0.5874928238079925
ʔaḥ	67	15	12	94	0.7254381131244901
waʔič	0	9	0	9	0
ʔana	0	10	2	12	0.41011848630651815
ʔaḥ	67	15	13	95	0.7371865046470237
kuḥ	3	1	0	4	0.5118595071429148
hin-iːʔas	0	7	0	7	0
ʔuːš-yuːya	0	25	0	25	0
ʔac	0	6	0	6	0
ʔaḥ	68	15	13	96	0.7327976446834549
qʷaː	43	82	0	125	0.585878273834613
ʔana-ʼi·c	0	4	0	4	0
ƛ̓aːq	7	0	0	7	0
ƛ̓aqapt	4	0	0	4	0
qʷi-ʼi·c	5	0	0	5	0
qʷayac̓iːk	59	0	0	59	0
ƛaḥ	1	12	0	13	0.2468472051870251
ʔaḥ	68	15	14	97	0.7437019077554392
ʕuy̓i	4	0	0	4	0
čuː	0	71	0	71	0
kʷis-q	0	4	0	4	0
ƛuːkʷaːna	4	3	0	7	0.6216097450797567
ʔiːqḥ	0	19	0	19	0
qʷayac̓iːk	60	0	0	60	0
ʔu-ca	0	42	0	42	0
ḥuːɬ	3	12	0	15	0.4554859150035953
waː	0	101	0	101	0
ḥuː	4	21	0	25	0.4002047709973934
ʔaḥʔaː	52	48	1	101	0.674521966972539
ƛuːkʷaːna	4	4	0	8	0.6309297535714575
ʔu-ca	0	43	0	43	0
waː	0	102	0	102	0
ʔu-ca	0	44	0	44	0
ʔu-ca	0	45	0	45	0
ḥaːɬ	5	14	2	21	0.760902980161762
ʔuḥ	0	28	0	28	0
ḥaː	7	15	0	22	0.5693467715383745
ƛawaː	0	4	0	4	0
qʷaːƛaː	0	10	0	10	0
ʔaya	2	23	6	31	0.6518600468319214
yaqʷ-(č)iɬ	15	4	0	19	0.46845749928108243
waː	0	103	0	103	0
ʔu-sa·ḥi	0	4	0	4	0
ʔu-sa·ḥi	0	5	0	5	0
ɬuːcsaːmiːḥ	5	0	0	5	0
ḥaːkʷaːƛ	5	0	0	5	0
ḥaw̓iɬ	27	6	0	33	0.43158020163114585
ʔu-na·k	1	27	0	28	0.14024611344719426
ʔu-ca	0	46	0	46	0
hist-ʼiƛ	0	4	0	4	0
ʔaḥ	69	15	14	98	0.7393920464570781
ḥaw̓iɬ	28	6	0	34	0.42417080326490036
ḥaːkʷaːƛ	6	0	0	6	0
qʷaːƛaː	0	11	0	11	0
ḥaːw̓iɬaƛ	16	2	0	18	0.3175206571427802
ʔu-ca	0	47	0	47	0
ḥaw̓iɬ	29	6	0	35	0.41702080323255053
ʕimtiː	4	0	0	4	0
yaqʷ-(č)iɬ	16	4	0	20	0.4554859150035953
mamaɬn̓i	15	1	0	16	0.21280633861277304
waː	0	104	0	104	0
yaqʷ-(č)iɬ	17	4	0	21	0.44320704809783756
huḥtak	0	32	0	32	0
ʔaḥ	70	15	14	99	0.7351298185372119
qʷaː	43	83	0	126	0.5842590440032965
ḥaw̓iːḥ	4	0	0	4	0
muː	0	3	1	4	0.5118595071429148
ḥaw̓iːḥ	5	0	0	5	0
hiš	3	3	2	8	0.985056822321508
muː	1	3	1	5	0.8649735207179273
muː	2	3	1	6	0.920619835714305
čuː	0	72	0	72	0
qʷis-ckʷi·	1	3	0	4	0.5118595071429148
ʔaḥʔaː	53	48	1	102	0.6737921566157222
qʷayac̓iːk	61	0	0	61	0
wik	1	133	0	134	0.0400376137521699
wik	1	134	0	135	0.03979135656216536
ʔuːš-yuːya	0	26	0	26	0
y̓uːqʷaː	0	43	0	43	0
ḥaːw̓iɬaƛ	17	2	0	19	0.3062916381460314
yaqʷ	15	1	0	16	0.21280633861277304
ʕiniːƛ	25	2	0	27	0.24035053544298987
ʕiniːƛ	26	2	0	28	0.2342215203652865
ʔu-kɬa·	0	21	0	21	0
hiʔiːs	1	9	0	10	0.2959032742893846
ḥaː	7	16	0	23	0.559345027039261
ʔuyaː-siɬa	0	7	0	7	0
ʕiniːƛ	27	2	0	29	0.22842890703676905
ƛawa-ʔiː	0	6	0	6	0
ʔaḥ	70	16	14	100	0.7447042994948687
wik	1	135	0	136	0.03954835081134872
ɬač	0	5	0	5	0
yaːɬ	0	7	0	7	0
ʔaḥ	71	16	14	101	0.7405262832473539
suč̓as	10	0	1	11	0.2772917256537885
tuxʷ-cpa·	0	4	0	4	0
qʷayac̓iːk	62	0	0	62	0
n̓aːcsa	0	32	0	32	0
qʷayac̓iːk	63	0	0	63	0
ʔuyaː-siɬa	0	8	0	8	0
ʔaḥ	72	16	14	102	0.7363928528294313
qʷis	13	46	0	59	0.48000251920058096
wik	1	136	0	137	0.03930853070178388
sut-(č)iɬ	0	12	0	12	0
waː	0	105	0	105	0
wik	1	137	0	138	0.03907183222529389
sut-(č)iɬ	0	13	0	13	0
wiːq-ḥap	0	4	0	4	0
qʷaː	43	84	0	127	0.5826358429384695
ʔaḥʔaː	54	48	1	103	0.6729964077490067
huʔa-ca	0	25	0	25	0
tuxʷ-cpa·	0	5	0	5	0
kʷis-tu·p	0	4	0	4	0
muwač-m̓i·t	26	0	0	26	0
wim̓aːqƛ	0	11	0	11	0
wa·	6	187	0	193	0.1260720864928766
ʔu-n̓a·ḥ	0	19	0	19	0
m̓uksy̓i	7	0	0	7	0
muwač-m̓i·t	27	0	0	27	0
wik	1	138	0	139	0.03883819310246045
čakup	18	0	0	18	0
mamuːk	0	10	0	10	0
muwač-m̓i·t	28	0	0	28	0
wa·	6	188	0	194	0.125570021037807
ʔan	0	8	0	8	0
kʷis-tu·p	0	5	0	5	0
wa·	6	189	0	195	0.12507233704745038
muwač-m̓i·t	29	0	0	29	0
wa·	6	190	0	196	0.12457897539829445
ʔu-ḥʷʼaɬ	0	18	0	18	0
ʔaḥ	73	16	14	103	0.7323035806622109
č̓iːma	4	0	0	4	0
wim̓aːqƛ	0	12	0	12	0
kʷis-tu·p	0	6	0	6	0
wa·	6	191	0	197	0.12408987804479198
muwač-m̓i·t	30	0	0	30	0
č̓iːma	5	0	0	5	0
quːʔas	77	2	0	79	0.1074666280896612
č̓iːma	6	0	0	6	0
wa·	6	192	0	198	0.12360498799464747
č̓iːma	7	0	0	7	0
muwač-m̓i·t	31	0	0	31	0
sukʷi(ƛ)	0	18	0	18	0
č̓iːma	8	0	0	8	0
kʷis-ʼa·tḥ	4	0	0	4	0
wa·	6	193	0	199	0.12312424928478477
kʷis-ʼa·tḥ	5	0	0	5	0
čukʷaː	0	6	0	6	0
t̓uḥc̓iti	11	2	0	13	0.3907866554552209
ƛ̓uč̓um-ckʷi·	4	0	0	4	0
muwač-m̓i·t	32	0	0	32	0
sukʷi(ƛ)	0	19	0	19	0
m̓uksy̓i	8	0	0	8	0
wa·	6	194	0	200	0.12264760695797416
muwač-m̓i·t	33	0	0	33	0
m̓uksy̓i	9	0	0	9	0
piḥ	0	9	0	9	0
wa·	6	195	0	201	0.12217500704009804
ʔu-ḥta·	0	7	0	7	0
m̓uksy̓i	10	0	0	10	0
sukʷi(ƛ)	0	20	0	20	0
m̓uksy̓i	11	0	0	11	0
čaʔaːɬ-či·	0	6	0	6	0
muwač	9	1	0	10	0.2959032742893846
ʔaḥʔaː	55	48	1	104	0.672138847969536
qʷis	13	47	0	60	0.47574252126094346
muwač	9	2	0	11	0.43158020163114585
muwač-m̓i·t	34	0	0	34	0
yac	0	4	0	4	0
ʔu-waƛ	0	4	0	4	0
ƛawa-ʔiː	0	7	0	7	0
kʷis-ʼatḥ	3	0	1	4	0.5118595071429148
mamuːk	0	11	0	11	0
wa·	6	196	0	202	0.12170639651803422
kʷis-tu·p	0	7	0	7	0
quːʔas	78	2	0	80	0.10641319994632664
wim̓aːqƛ	0	13	0	13	0
kʷis-tu·p	0	8	0	8	0
ʔan	0	9	0	9	0
wa·	6	197	0	203	0.12124172331813746
naʔa·	0	17	0	17	0
qʷaː	44	84	0	128	0.5857312535611813
sukʷi(ƛ)	0	21	0	21	0
ʕat̓uː-m̓i·t	4	0	0	4	0
kʷis-ʼatḥ	4	0	1	5	0.4554859150035953
ƛuɬ	2	5	0	7	0.5445684476282008
wa·	6	198	0	204	0.1207809362853011
ʕat̓uː-m̓i·t	5	0	0	5	0
ʕat̓uː-m̓i·t	6	0	0	6	0
ʔuxʷaːpi	3	1	0	4	0.5118595071429148
ʕat̓uː-m̓i·t	7	0	0	7	0
wa·	6	199	0	205	0.12032398516257903
ʔunw̓iːƛ	0	13	0	13	0
wiːy̓a	0	20	0	20	0
